wwwwwwwwwwwwwwwwwwwww
w.........w.........w
w..wwww...w...wwww..w
w.........w.........w
w....w....A....w....w
w....w....w....w....w
w....www..1..www....w
w..www.........www..w
w...0.....w........Bw
wwwwwwwwwwwwwwwwwwwww