wwwwwwwwwwwwwwwww
w....e..........w
w...............w
w...............w
w...............w
w......A........w
w....www...wwww.w
w..........w....w
w...............w
w.......w....s..w
w.......w.......w
w........w......w
w..k............w
w..ww...........w
w...w.....www...w
w.........B.....w
wwwwwwwwwwwwwwwww