wwwwwwwwwwwwwwwww
w..........w.k..w
w..w.......w....w
w..w........w...w
w..w....A.......w
w...............w
w...............w
w.......s.......w
w....www.www....w
w...............w
w.......B.......w
w..w............w
w...w...........w
w...ww...w......w
w........w......w
w........w......w
w........www....w
w...............w
w.......e.......w
wwwwwwwwwwwwwwwww