1.............................
000...........................
000...........................
..............................
.............0..0.............
..00.........0..0.........00..
..00.........0..0.........00..
..00.........0..0.........00..
..00......................00..
..............................
........A............B........