1.............................
000...........................
000...........................
..............................
..............................
.0000....................0000.
.0000....................0000.
....0000....00..00....0000....
....0000......00......0000....
..............................
........A............B........