................................
........bbb............b........
...bbbb...h....bb......b...B....
...h...................b........
.......p..b....h.............bb.
..........b............h........
........bb....p....bb...........
..................b.....p......b
....h.............b.......h....b
.bb.........b...................
........b...b.........bbbb......
........bA........bbb...........
........b........h..............
................................