.............................h...
.A...b........bbbbb..............
.....b....h...b...b.....p........
.....b.p......b.b.b..............
.....b...........................
.bbbbb..........b...........p....
..h...........bbbbb..............
................b....p...........
...........................bbbbb.
.....h......bbbb.bbbb......b.....
.p..........b..bbb..b......b.....
............b.......b..h...b.....
.............b.....b.......b...B.
.......h.........................