wwwwwwwwwwwwwwwwwwww
w.bbb.000.A..b...b.w
w...bb....b...bbb..w
w....b...b.....bbbbw
wbb.....bbb....bb..w
w..bb...bbb......bbw
wbbbb.....b...b....w
w..bbb...b....bb..bw
w.b...b..B.111.bbb.w
wwwwwwwwwwwwwwwwwwww