wwwwwwwwwwwwwwwwwww
w.bb..b.bb..b...b.w
wbb....b.b..bbbb..w
w..bbb.bbA.b.b.bb.w
wbb.b.b.bbb.bb..b.w
w.b..bb.bbb.b.b.bbw
w.bb.b.b.Bbb.bbb..w
w..bbbb..b.b....bbw
w.b...b..bb.b..bb.w
wwwwwwwwwwwwwwwwwww