wwwwwwwwwwwww
w.....w.....w
w...0...1...w
wa.........bw
w.A.0...1.B.w
wc.........dw
w...0...1...w
w.....w.....w
wwwwwwwwwwwww