wwwwwwwwwwwww
ww.........ww
w...0...1...w
wa.........bw
w.A.......B.w
wc.........dw
w...0...1...w
ww.........ww
wwwwwwwwwwwww