wwwwwwwwwwwwwwwwwwww
w..................w
w..+++++.........@.w
w..+++++...+++.....w
w..+++++++++++.....w
w....+++*+++.......w
w....+++B+++.....A.w
w....+++++++.......w
w....+++++++++.....w
w..+++++...+++.....w
w..+++++...........w
w..................w
wwwwwwwwwwwwwwwwwwww
