wwwwwwwwwwwwwwwwwwww
w......xx..........w
w.@...........xx...w
w...............x..w
w....+xx++++++..x..w
w....x++++x+*+.....w
w....x++B+++++.....w
w....+++++++++.....w
wxx..+++x+++++.....w
w.......x......xx..w
w..A....x.......x..w
w...............x..w
wwwwwwwwwwwwwwwwwwww
