....A....
a00010000
......00p
wwwwwwwww
....B....
b00010000
......00e