....A....
a0001000p
.........
wwwwwwwww
.........
b0001000e
....B....