....A....
a000.5003
...002..1
...00000p
wwwwwwwww
....B....
b000.5003
...002..1
...00000e