wwwwwwwwwwwwwwwwwwwwwwwww
w.......................w
w....A.www.wwww.ww......w
w..w......x......www....w
w..w...w.....x.......B..w
w..www.wx........www....w
w......wwwwww...xw......w
w.............wwww......w
w..x.................x..w
wwwwwwwwwwwwwwwwwwwwwwwww