........A........
.................
...+...........$.
...............$.
.$....-...&....$.
.$...............
.$...........%...
.................
........B........