.%%.....A....&&&.
.................
...++.........--.
....-..$.........
.......$$$.......
.........$..-....
.--.........++...
.................
.&&&....B.....%%.