........A........
.................
.................
.......&.+.......
.....%.&.+.%.....
.......&.+.......
.................
.................
........B........