....&...........
..&&&...........
.........-.-....
....A....---....
................
.............%..
................
....+++......B..
................