wwwwwwwwwwwww
wA..1h1h1..Bw
w..1..1..1..w
w1....1....1w
www.whhhw.www
w..1.....1..w
w1..1...1..1w
w..h11x11h..w
wwwwwwwwwwwww
