wwwwwwwwwwwww
w....1x1....w
w.1h.....h1.w
w1.1111111.1w
wh.1..1..1.hw
www.1...1.www
w...1.1.1...w
wA.1..h..1.Bw
wwwwwwwwwwwww
