wwwwwwwwwwwwwwwwwww
wx..w..x.w.x..w...w
w..xwx...w....w.x.w
w.ww.ww.B.A.ww.ww.w
w.x......w.x..x...w
w..wwww..w..wwwwddw
w........wx...w...w
w.o.w....w..x.w.b.w
wx..w..x.w....w...w
wwwwwwwwwwwwwwwwwww