ppppppppppp
pppppppuppp
pplArppBppp
pppppppdppp
ppppppppppp
w.c....w..w
ww.ww.....w
wc.....c+.w
w.c.ww.g.ww
w...wc....w
w...w.....w
w.t....+wcw
wwwwwwwwwww
