wwwwwwwwwwwwwww
w........e....w
w..e...r......w
w.............w
0.A....b....B.1
w.............w
w......q......w
w...r....q....w
wwwwwwwwwwwwwww