wwwwwwwwwwwwwwwww
w..........r....w
0...q.w.........1
0.....w.........1
0.A..ww.b.ww..B.1
0.........w.....1
0.........w.....1
w...r......q....w
wwwwwwwwwwwwwwwww