wwwwwwwwwwwwwwwwwwww
w..................w
w.......0.....1....w
w...A..............w
w..................w
w..1...............w
w.........1........w
w...............B..w
w..................w
wwwwwwwwwwwwwwwwwwww