wwwwwwwwwwwwwwww
w.w..1...w...w.w
w.w......w...w.w
w...w..w.....w.w
w+w.w..wA..w.1.w
w+w.w..ww..w.w.w
w++.....w....w.w
w....w..w....w.w
w.w..w....w....w
w.w..w.w..w.--.w
w....w.w..w.--.w
w.0...Bw.......w
wwwwwwwwwwwwwwww