wwwwwwwwwwwwwwww
w..w.....B.w...w
w.2w.wwww..w...w
ww...w++w....www
www..w++w......w
w.w...w.....1..w
w.w......1.....w
w...w..wwwww.2.w
w.A.w..0..wwww.w
w...www.www..+.w
w.w.---...ww.+ww
w..wwwww.....++w
wwwwwwwwwwwwwwww