wwwwwwwwwwwwwwww
w++..A.....ww..w
w++......w...2.w
w...wwww.wwww..w
w.w.w......w...w
w.wwww.ww..w.w.w
w.......w....w.w
w.wwww..w.B..w.w
w.w..w....ww...w
w.w..w.--.w....w
w....w.wwww....w
w..2.........2.w
wwwwwwwwwwwwwwww