hhhhhhhhhhhhhhhhh
hA____bhu_hh___hh
h_h______h___q_bh
hbh_ww_____ww_hhh
hhb_0w__f__w0_bhh
hhh_ww_____ww_hbh
hb_q__________h_h
hh___hh_uhb____Bh
hhhhhhhhhhhhhhhhh