wwwwwwwwwwwwwwww
w.+..w.....w...w
w....d..B..w.c.w
wwwwww...www...w
w...c....w...c.w
w.wwww..ww.....w
w.ww....ww.A.*.w
w..w..c.w......w
wwwwwwwwwwwwwwww