wwwwwwwwwwwwwwwwwwwwwwwwwwwwwwww
w..............g...............w
w..............................w
w..............................w
w..............................w
w..............................w
w..............................w
w..............................w
w..............................w
w..............................w
w..............................w
w..........A........B..........w
wwwwwwwwwwwwwwwwwwwwwwwwwwwwwwww