wwwwwwwwwwwwwwwwwwwww
w........lur........w
w........lAr........w
w........ldr........w
wwwwwwwwwwwwwwwwwwwww
w1.................0w
w1.a.........a...b.0w
w1..a..w..tt..b....0w
w1...a....w....b...0w
w1....a..tt..w..b..0w
w1.a...b.........b.0w
w1.................0w
wwwwwwwwwwwwwwwwwwwww
w........lur........w
w........lBr........w
w........ldr........w
wwwwwwwwwwwwwwwwwwwww
