wwwwwwwwwwwwwwwwwwwww
w........lur........w
w........lAr........w
w........ldr........w
wwwwwwwwwwwwwwwwwwwww
w1........t........0w
w1a.a.....t.....b.b0w
w1.a.............b.0w
w1a.a...........b.b0w
w1.a.............b.0w
w1a.a.....t.....b.b0w
w1........t........0w
wwwwwwwwwwwwwwwwwwwww
w........lur........w
w........lBr........w
w........ldr........w
wwwwwwwwwwwwwwwwwwwww
