wwwwwwwwwwwwwwwwwwwww
w........lur........w
w........lAr........w
w........ldr........w
wwwwwwwwwwwwwwwwwwwww
w1a.......w.......b0w
w1a...............b0w
w1aa.............bb0w
w1aa......t......bb0w
w1aa.............bb0w
w1a...............b0w
w1a.......w.......b0w
wwwwwwwwwwwwwwwwwwwww
w........lur........w
w........lBr........w
w........ldr........w
wwwwwwwwwwwwwwwwwwwww
