wwwwwwwwwwwwww
w.....w......w
w.x.x.w..o.o.w
w.....w..A...w
w.x........o.w
wwwwwwww..wwww
w.o..........w
w....B...w...w
w......x.w.d.w
wwwwwwwwwwwwww