wwwwwwwwwwww
w...w......w
w.x.w......w
w......A.x.w
wwwww..wwwww
wo.........w
w....B.w...w
w....o.w.d.w
wwwwwwwwwwww