xxxxxxxxxxxxxxxxxxxxx
xwwwwwwwwwwwwwwwwwwwx
xw.................wx
xw.c...............wx
xw.................wx
xw...............A.wx
xw.................wx
xw.T...............wx
xw.................wx
xwwwwwwwwwwwwwwwwwwwx
xxxxxxxxxxxxxxxxxxxxx