wwwwwwwwwwwwwwwwwwwwww
w.......x.........A..w
w.......x...ww.......w
w.......x...ww.......w
wxxxxxxxwwwwwwxxxxxxxw
w.......wwwwww.......w
w.T........xx....ww..w
w..........ww....wwwww
w.........cww....wwwww
w..........ww........w
w..........xx........w
wwwwwwwwwwwwwwwwwwwwww