wwwwwwwwwwwwwwwwwwwwwww
wddddd..,,,,,,,..dddddw
w.......,,,,,,,.......w
w....r.d,,,,,,,d.l....w
w....r.d,,,,,,,d.l....w
w....r.d,,,,,,,d.l....w
w.......,,,,,,,.......w
w...A...,,,,,,,...B...w
wwwwwwwwwwwwwwwwwwwwwww
