wwwwwwwwwwwwwwwwwwwwwww
w.......,,,,,,,.......w
w.....r.,,,,,,,.d.....w
w...d...,,,,,,,...l...w
w.r.....,,,,,,,.....d.w
w.....d.,,,w,,,.l.....w
w.......,,,w,,,.......w
ww.w...w,,,,,,,w...w.ww
ww.w...w,,,,,,,w...w.ww
w.....r.,,,w,,,.d.....w
w..d....,,,w,,,....l..w
w....r..,,,,,,,..d....w
w.d.....,,,,,,,.....l.w
w...A...,,,,,,,...B...w
wwwwwwwwwwwwwwwwwwwwwww
