wwwwwwwwwwwwwww
w.........++++w
w.A....w..++++w
w....-----++++w
w...w--0--w+++w
w...w--*--w+++w
w...w--1--w+++w
w....-----++++w
w....++w++++B+w
w....+++++++++w
wwwwwwwwwwwwwww
