wwwwwwwwwwwwwwwwwwwwwwwww
w..........---++++++++++w
w.A...w....---++++w+++++w
w....---+++---...---++++w
w....---+++---...---++++w
w-.w--0-----*-----1--w+-w
w....---...---+++---++++w
w....---...---+++---++++w
w.....w....---++++w+++B+w
w..........---++++++++++w
wwwwwwwwwwwwwwwwwwwwwwwww
