wwwwwwwwwwwwwwwwwwwwwww
w..........e..........w
w.....................w
w.w...w.........w...w.w
w.wwwww.........wwwwwpw
w..........w..........w
www........w........www
w..........w..........w
w..w.......w.......w..w
w..w.....wwwww.....w..w
w..w...............w..w
w.......A..d..B.......w
wwwwwwwwwwwwwwwwwwwwwww