wwwwwwwwwwwwwwwwwwwwwwwww
w....................d..w
w......w.........w..www.w
w......wwww...wwww......w
w.......................w
www.........e.........www
w.........wwwww.........w
w...w......w.w......w...w
w...w...............w...w
w...www...........www.A.w
w...w.ww.........ww.w...w
w.p.w.................B.w
wwwwwwwwwwwwwwwwwwwwwwwww