wwwwwwwwwwwwwwwwwwwwwwwwwwww
w.x....w...............w..xw
w......w............w......w
w......w............w..wwwww
w......wwwwwwwwww...w......w
www..www........wwwww.wwwwww
w...............w..........w
www..www...................w
w......w........w...A..B...w
w.....xw........w..........w
wwwwwwwwwwwwwwwwwwwwwwwwwwww
