wwwwwwwwwwwwwwwwwwwwwwwwwwww
w..........................w
w....w...............w.....w
w...w.....wwwwwww.....www..w
w..ww.....w..A..w..........w
w.........w.....w..........w
w.........ww...ww..........w
w...w..................www.w
w.x.w........B.........w...w
w........................x.w
wwwwwwwwwwwwwwwwwwwwwwwwwwww
