wwwwwwwwwwwwwwwwwwwwwwwwwwww
w.....................w..x.w
w...........w.........w....w
w...........w...........wwww
w.....A.....w...B..........w
w...........w..............w
w...........w.........w....w
w...........w.........w....w
w.......www...........w.x..w
w.......wx.................w
wwwwwwwwwwwwwwwwwwwwwwwwwwww
