wwwwwwwwwwwwwwwwwwwwwwwwwwww
w.....x.....www............w
w...www.............w......w
w.......w...........w......w
w.......w..........xw......w
www...www..www....www..wwwww
w............w.........w...w
w............w.........wx..w
w...w........w.............w
w.x.w...A..........B.......w
wwwwwwwwwwwwwwwwwwwwwwwwwwww
