wwwwwwwwwwwwwww
w...w..x..w...w
w.0.ww...ww.0.w
w.............w
w....0.w.0....w
w.A....w....B.w
w.0...www...0.w
w....ww.ww....w
w......0......w
w01.00.1.00.10w
wwwwwwwwwwwwwww