wwwwwwwwwwwww
w----w.e.---w
w----w-.-.--w
w-A--1--.2.-w
wwwwwwwwwwwww
w--.3w-----.w
w-B-.0----.ew
w----w-----.w
wwwwwwwwwwwww
