wwwwwwwwww
w---w--.ew
w-A-w---.w
w---1----w
wwwwwwwwww
w-.----.ew
w.3.-B--.w
w-.------w
wwwwwwwwww
