wwwwwwwwwwwww
w++++++++0..w
w+1.bbb..0..w
w+A....000..w
w++++++000..w
wwwwwww000www
w++++++000..w
w+.B.bb..0..w
w+......00..w
w+++++++00.gw
wwwwwwwwwwwww
