wwwwwwwwwwwwwwwwwwwwwwww
w............0dppppppp3w
w.H............p.......w
w............0.p.0.0.0.w
w..............p.......w
w............0.p.......w
w..............p.......w
w.....0dpppppppp.......w
w.......p......l.......w
w.....0.p.0.0.0........w
w.......p..............w
w.....0.p..............w
w.......p..............w
w.......p............V.w
w.......t..............w
wwwwwwwwwwwwwwwwwwwwwwww
