wwwwwwwwwwwwwwwwwwww
w........dpppppppp3w
w.......0.p........w
w...H...0.p........w
w.........p....l...w
w..dpppppppppppp...w
w...p.....p....p...w
w.0.p.000.p....p...w
w...p.....p....p...w
w.0.p.....ppppppu..w
w...p.....r........w
w.0.p.......000....w
w...p..............w
wwwwt.......V......w
wwwwwwwwwwwwwwwwwwww