wwwwwwwwwwwwwwwwww
w....2+bA+++3....w
w....+......+....w
w....+......+....w
w....+......+....w
wr+bbb++Bb++b+++dw
w+...+......+...+w
w+...+......+...bw
wa...b......a...+w
w+...+......a...+w
wa...+......+...+w
w+...+......+...+w
wub++b++aa++b+++lw
w....b......+....w
w....b......+....w
w....+......+....w
w....1++a+a+4....w
wwwwwwwwwwwwwwwwww
