wwwwwwwwwwwwwwwwwwwwwwwwwwwww
w...........r+bb+B++d.......w
w...........+.......+.......w
w...........+.......+.......w
w2b++b++b+++aA++3...rbb++++dw
w+..........+...+..........+w
w+..........+...+..........+w
w1++++bb4...u+++a+++b++b++blw
w.......+.......+...........w
w.......+.......+...........w
w.......1++++bb+4...........w
wwwwwwwwwwwwwwwwwwwwwwwwwwwww
