-----A----
-.+.+a+.+-
-+.+.+.+.-
-.+.+3+.+-
-+.+.+.+.-
-.+.+.+.+-
-+.+.i.+.-
-.+.+.+.+-
-+.+.b.+.-
-----B----