-----A----
-.+.+a+.+-
-+.+.u.+.-
-.+1414.+-
-+.+1+.+.-
-.+.+e+.+-
-+.yeye+.-
-.+.+2+.+-
-+.+.b.+.-
-----B----