wwwwwwwwwwwwwwwwwwww
w........__........w
w.a..a...__...b..b.w
w.a..a.+.__...b..b.w
w1a..a...__.=.b..b1w
w2....A..__..B....2w
w3a..a.+.__...b..b3w
w.a..a...__.=.b..b.w
w.a..a...__...b..b.w
w........__........w
wwwwwwwwwwwwwwwwwwww