wwwwwwwwwwwww
w+++++++++++w
w+.m..s..l.+w
w+....s....+w
w+A.a...b.B+w
w+....s....+w
w+.l..s..m.+w
w+++++++++++w
wwwwwwwwwwwww