wwwwwwwwwwwww
w+++++++++++w
w+.l.l.l.l.+w
w+....k....+w
w+A.a...b.B+w
w+....k....+w
w++.+++++.++w
www0wwwww0www
w++.++w++.++w
w+...+w+...+w
w+sss+w+mmm+w
w+++++w+++++w
wwwwwwwwwwwww