wwwwwwwwwwwww
w+++++++++++w
w+.s.s.s.s.+w
w+.........+w
w+A.a.k.b.B+w
w+...s.s...+w
w+++.+++++++w
wwww0wwwwwwww
w+++.+++++++w
w+.........+w
w+..lll.mmm+w
w+++++++++++w
wwwwwwwwwwwww