wwwwwwwwwwwwwwwwwwwwwww
wh......w.+.=.w......1w
w......ww..A..ww......w
w.r.....w.....w.......w
w.......2.........r...w
w.......s.............w
w............s........w
w.............3.......w
w..r....w.....w....r..w
w......ww..B..ww......w
wu......w.=.+.w......hw
wwwwwwwwwwwwwwwwwwwwwww