wwwwwwwwwwwwwwwwwwwwwww
w.2.....w.+.=.w.....1.w
w....wwww..A..wwww....w
w.w....1.......3......w
w.w.s.....www.......s.w
w.w...w....h....w.....w
w.....w....h....w...w.w
w.s.......www.......w.w
w......3.......1..s.w.w
w....wwww..B..wwww....w
w.1.....w.=.+.w.....2.w
wwwwwwwwwwwwwwwwwwwwwww