wwwwwwwwwwwwwwwwwwwwwww
w.2.....w.+.=.w.....1.w
w....wwww.....wwww....w
w.w........3........w.w
w.w..r....www....r..w.w
w.........w.w.........w
w.....wA...h...Bw.....w
w.s...w.........w...s.w
w....s...w...w...s....w
w.wwww...w.u.w...wwww.w
w...ww...ww.ww...ww...w
wwwwwwwwwwwwwwwwwwwwwww