wwwwwwwwwwwwwwwwwwwwwww
w.......w.+.=.w.....u.w
w....wwww..A..wwww....w
w.r.....w.....w.......w
w.........www.....r...w
w.....w.r.......w.....w
w.....w......r..w.....w
w.........www.........w
w..r....w.....w....r..w
w....wwww..B..wwww....w
w.u.....w.=.+.w.......w
wwwwwwwwwwwwwwwwwwwwwww