wwwwwwwwwwwwwwwww
w*.....-....*wwww
w.A....-.....wwww
w.B....-..w--wwww
w......-..w..0..w
w......-..w....*w
w......-..w.....w
w......-0.w-----w
w......-..w.....w
w......-..w.....w
w+.....-..w..d..w
wwwwwwwwwwwwwwwww
