wwwwwwwwwwwww
w.w.w....3w3w
w.1...w....1w
w2.........ww
w....3..3...w
w......3.2wAw
w1.......1..w
w.22....g.+.w
wwwwwwwwwwwww