wwwwwwwwwwwww
ww.........3w
w........1..w
w.w.........w
w12.........w
w..1..2....3w
w...w2+g...ww
w1..ww.Aw..ww
wwwwwwwwwwwww