wwwwwwwwwwwww
w..3........w
w....2...w2.w
w3.......33gw
w.ww+..w....w
ww......2w.3w
w...........w
w..A........w
wwwwwwwwwwwww