wwwwwwwwwwwww
w..w........w
w1........1.w
wwAw.31w....w
w.+.........w
w..........ww
w...g.....3ww
w12.3.......w
wwwwwwwwwwwww