wwwwwwwwwwwww
w22.........w
w........2..w
w.ww........w
w1.......1..w
w3....2....3w
w..3..+g....w
w1...3.Aw...w
wwwwwwwwwwwww