wwwwwwwwwwwww
ww.3w...w.A.w
w.......wg..w
w2.....w...+w
w2.........ww
w......3..w.w
w.3..2.2w...w
w...3.......w
wwwwwwwwwwwww