wwwwwwwwwwwww
w.......2...w
w1........1.w
wwA3.31w....w
w.+.g..w....w
w......2w.3ww
w..1......www
w12.3.......w
wwwwwwwwwwwww