wwwwwwwwwwwww
w........3..w
w12..w...2..w
ww2w....+3..w
w.w......gw.w
wA.........1w
w.....w.....w
w3.21...1...w
wwwwwwwwwwwww