wwwwwwwwwwwww
w.......w.1.w
w...3....w..w
w...w1.....+w
w..1.2..w...w
w......A.w..w
w...w.3ww2..w
wgw.1...3...w
wwwwwwwwwwwww