wwwwwwwwwwwww
w..A......2.w
w33...+.....w
w......ww...w
w.1.g...w...w
w.......21..w
w...........w
w...1..w1..ww
wwwwwwwwwwwww