wwwwwwwwwwwww
w3....2+.g..w
w.....w...w.w
w.........2.w
w...2.......w
w....w..w...w
w..ww..w..3.w
w..wA31.....w
wwwwwwwwwwwww