wwwwwwwwwwwww
w.....A.....w
ww.3.......3w
w...w...w...w
w..2........w
w..2.......ww
w1w......w..w
w2gww....+23w
wwwwwwwwwwwww