wwwwwwwwwwwww
w..w2...w.A.w
ww......3g.1w
w......w...+w
w3.........ww
w......w..w.w
w.32.2.2w...w
w...3.......w
wwwwwwwwwwwww