wwwwwwwwwwwww
w2...w1..ww1w
w.....ww31..w
w.w2......12w
w..........ww
w....323w..3w
w..3w.+gw...w
w1...2.Aw...w
wwwwwwwwwwwww