wwwwwwwwwwwww
w...12www.A.w
ww.......w.ww
w....w.w...+w
w3...2w..g.ww
w..1.....3..w
w......222..w
w.w.........w
wwwwwwwwwwwww