wwwwwwwwwwwww
w..3........w
w........w2.w
ww.......23gw
w.ww+..w....w
ww......2.32w
w.........1.w
w..A.......1w
wwwwwwwwwwwww