wwwwwwwwwwwww
w2..........w
w...........w
www.........w
w....w2..1..w
w3...w.....3w
w..3w2+g..1.w
w1...3.Aw...w
wwwwwwwwwwwww