wwwwwwwwwwwww
w..2..w.1...w
w+w.2.......w
w...g.3w.w11w
w...........w
w.....2..w..w
w....Aw.....w
w.....12....w
wwwwwwwwwwwww