wwwwwwwwwwwww
ww.3w.....32w
w.........2ww
w2.3........w
w2.....A.g1.w
w......+1.32w
w3........1.w
www.....1.1ww
wwwwwwwwwwwww