wwwwwwwwwwwww
w...........w
w1........1.w
w.Aw.3.w....w
w.+.........w
w.........www
w..1g2....www
w12.33......w
wwwwwwwwwwwww