wwwwwwwwwwwww
w.1...21...1w
w...w.......w
w...3.......w
w..3A1.+....w
w32..3.g....w
ww..1.w.....w
w.w...2.2..3w
wwwwwwwwwwwww