wwwwwwwwwwwww
w1..........w
w.........1.w
w..w.31w....w
w31w.g3...w.w
w.22...w.1.ww
ww.......ww+w
www.A...3.3.w
wwwwwwwwwwwww