wwwwwwwwwwwww
w...w+..1...w
w1....w.....w
w....A....12w
w..2......w3w
w....g......w
w3.2.......2w
w...3...2w..w
wwwwwwwwwwwww