wwwwwwwwwwwww
w..A..2...2.w
w32.w.+.....w
w.1ww.2ww...w
w.1..g3...3.w
w...........w
w.w....323..w
w...1..w1.w.w
wwwwwwwwwwwww