wwwwwwwwwwwww
w2..........w
w....w......w
w.w.........w
w....w2.....w
w....w.....3w
w.....+g3.3.w
w....23Aw..2w
wwwwwwwwwwwww