wwwwwwwwwwwww
w..3........w
w........w2.w
ww.......23gw
w.ww+..w....w
ww......2w.3w
w....w......w
w..A........w
wwwwwwwwwwwww