wwwwwwwwwwwww
w.1.w....3w3w
w.1...w....1w
w2.........ww
w....3..3...w
w......3.2wAw
w1.....w.1..w
w.222...g.+.w
wwwwwwwwwwwww