wwwwwwwwwwwww
w....2w1...ww
w..3..w.2..3w
w..ww.w3....w
w...1g....w.w
w1.....33.w+w
w..w...1.2..w
w..Aww..w2..w
wwwwwwwwwwwww