wwwwwwwwwwwww
w+..2...1.w.w
w....1w.....w
w....A....12w
w........ww3w
w....g...3w.w
w..2.......2w
w...w...2...w
wwwwwwwwwwwww