wwwwwwwwwwwww
w..w2...w.A.w
w.w......g.1w
w......w...+w
w31........1w
w......w..w.w
w.3..2.2w...w
w...3.......w
wwwwwwwwwwwww