wwwwwwwwwwwww
w...........w
w1........12w
wwAw.3.w....w
w.+.g....w..w
w........13ww
ww.1.....wwww
w12.3.w.3...w
wwwwwwwwwwwww