wwwwwwwwwwwww
w..3........w
w....2...w2.w
ww.......23gw
w.ww+2.w....w
ww......2w.3w
w...........w
w..A........w
wwwwwwwwwwwww