wwwwwwwwwwwww
ww23..g...www
w.......w..ww
w.+3..w.w..3w
wA...w2.1...w
w....w....w.w
w.2.w2w.....w
w.w...1w...1w
wwwwwwwwwwwww