wwwwwwwwwwwww
w3....2....2w
w.........2ww
w...........w
w..3A1.+....w
w31..3.g....w
ww..1.w.....w
w.ww........w
wwwwwwwwwwwww