wwwwwwwwwwwww
w.2w..1..w.+w
w.........21w
w2ww3..3g2.3w
w........w..w
w..1....w...w
w..A...w...ww
w2w.11......w
wwwwwwwwwwwww