wwwwwwwwwwwww
w..A..2...2.w
w31...+.....w
w..2...ww...w
w.w..g3.....w
w......2w...w
w.w....323..w
w...1..w1.w.w
wwwwwwwwwwwww