wwwwwwwwwwwww
w..A.w.1....w
w3.....3....w
w..3........w
w..........ww
ww.g+..2w...w
w...w.3w.21.w
w..2.21.3.2.w
wwwwwwwwwwwww