wwwwwwwwwwwww
w.23..g1....w
w...........w
w.+3....w..1w
w.w.w.......w
w.....2.....w
w....Aw.....w
w.....1.....w
wwwwwwwwwwwww