wwwwwwwwwwwww
w3..........w
w..1.A......w
w.w.+..1..3.w
w.w..2..2...w
w..3w....w1.w
w....wg...13w
w2.1.3.2....w
wwwwwwwwwwwww