wwwwwwwwwwwww
w...........w
w........1.ww
w.w........3w
w12.....w12.w
w..w..2....3w
w.13w2+g3...w
w12..w.Aw...w
wwwwwwwwwwwww