wwwwwwwwwwwww
w..A..2...2.w
w33...+.....w
w..w.3ww....w
w.w.........w
w..w...g.1..w
w.w..2.323..w
w1..1..w1...w
wwwwwwwwwwwww