wwwwwwwwwwwww
w..1w.......w
w....1..1.3.w
w.g....2...3w
w.33.....w.ww
w.A1..2.....w
w.+w.w..ww..w
w....w.3....w
wwwwwwwwwwwww