wwwwwwwwwwwww
w1.ww.....www
w.2......wwww
w.2w...w.2.ww
w.w..w...g.ww
ww.1w3.w.3A2w
ww....w2ww.ww
ww3.+.w.1...w
wwwwwwwwwwwww