wwwwwwwwwwwww
w..A......2.w
w33...+...1.w
w..2...ww...w
w.w..g3.....w
w........1..w
w....2......w
w...1..w1...w
wwwwwwwwwwwww