wwwwwwwwwwwww
w..2..w.1...w
w+w.2....1.ww
w...g.3w....w
w...........w
w.....2...13w
w....Aw....ww
w.....1.w..ww
wwwwwwwwwwwww