wwwwwwwwwwwww
w..3w....3..w
w....w...2..w
w.......+3..w
w........gw.w
wA...w.ww..1w
w...2.w2....w
w3.21...1...w
wwwwwwwwwwwww