wwwwwwwwwwwww
w2...w1...31w
w.w...w..1.ww
w.w........3w
w.w2w.....2.w
w2w..ww...w.w
www.w.+g1...w
w1.3.33A..w2w
wwwwwwwwwwwww