wwwwwwwwwwwww
w+3....w..w.w
w........w1gw
ww1..1.w....w
w.w2....22..w
w..1..2.....w
w........A.2w
w...3..33.w.w
wwwwwwwwwwwww