wwwwwwwwwwwww
ww.3.....1..w
w.....2.w3..w
w23......3w3w
w2.1...1....w
w..A..2....+w
w....w.1....w
w.2..g....1.w
wwwwwwwwwwwww