wwwwwwwwwwwww
w..A..2w..2.w
w33...+.....w
w..2...ww...w
w.w..g3.....w
w.......2...w
w.w......3..w
w...1..w1.w.w
wwwwwwwwwwwww