wwwwwwwwwwwww
w2.........3w
w........1..w
w.w.........w
w1......w1..w
w2.w..2....3w
w..3w2+g3...w
w1...w.Aw...w
wwwwwwwwwwwww