wwwwwwwwwwwww
w2...w1..ww1w
w.....w..1..w
w.w.......12w
w..........ww
w....323w..3w
w..3w.+gw...w
w1...2.Aw...w
wwwwwwwwwwwww