wwwwwwwwwwwww
w2..........w
w...........w
w.w.........w
w1..w....w..w
w3..3w.....3w
w..ww.+g....w
w1...3.Aw...w
wwwwwwwwwwwww