wwwwwwwwwwwww
w2.........3w
w........1..w
w.w.........w
w12......1..w
w..w.22....3w
w..3w2+g3...w
w1...w.Aw..1w
wwwwwwwwwwwww