wwwwwwwwwwwww
w.....A.....w
ww.3.......3w
ww......w...w
w...........w
w..........ww
w1w......w..w
w2gww....+23w
wwwwwwwwwwwww