wwwwwwwwwwwww
w2........w.w
w........12.w
w.w.......1.w
w1.......1w.w
w3...w....w3w
w..3w2+g....w
w1...3.Aw2..w
wwwwwwwwwwwww