wwwwwwwwwwwww
w.........w.w
w..3.w....2.w
w..w....+...w
w........g..w
wA........31w
w.....w...1.w
w3......1...w
wwwwwwwwwwwww