wwwwwwwwwwwww
w3....2....2w
w...w.......w
w1..3......2w
w..3A1.+....w
w3w....g....w
ww..1.w.....w
w.w3........w
wwwwwwwwwwwww