wwwwwwwwwwwww
w1.3w.1w....w
w...1.w.....w
w...w.2ww...w
w312.g32...2w
w.2....w.1.ww
ww.......w.+w
www.A.w.3.3ww
wwwwwwwwwwwww