wwwwwwwwwwwww
w...w+..1...w
w1.......w..w
w....A....12w
w.........w3w
w3...g......w
w3.2.......2w
w...3..32w..w
wwwwwwwwwwwww