wwwwwwwwwwwww
w..A.2....2.w
w33...+.....w
w..2...ww...w
w.w..g1.1...w
w........1w.w
w...........w
w...1.3.3...w
wwwwwwwwwwwww