wwwwwwwwwwwww
w.....A.....w
ww.3.......3w
ww..........w
w...........w
w........1..w
w1w........+w
w2gww.......w
wwwwwwwwwwwww