wwwwwwwwwwwww
w......w....w
w1..........w
w...w.2ww...w
w31..g3....2w
w........1.ww
www......w.+w
www.A.w.3.3ww
wwwwwwwwwwwww