wwwwwwwwwwwww
w2...w1..w31w
w..1..w..1.ww
w.w.....w.1.w
w...w.....w.w
w....w2.w.w.w
w.....+g32..w
w....23Aw..2w
wwwwwwwwwwwww