wwwwwwwwwwwww
w....w.2....w
w.2.........w
w.w2ww.w.3..w
w1.....+13..w
w.w....g..1ww
w.....w.2...w
w3..A.1..1..w
wwwwwwwwwwwww