wwwwwwwwwwwww
w..A........w
w33...+.....w
w...w2.ww...w
w.12.g3.....w
w....2...1..w
w...........w
w...1...3...w
wwwwwwwwwwwww