wwwwwwwwwwwww
w........32.w
w..w.....2..w
w....33.+3..w
w........gw.w
wA......2..1w
w.....w.....w
w3.21...1...w
wwwwwwwwwwwww