wwwwwwwwwwwww
w....1A.....w
ww.3........w
w.......w...w
w..........2w
w..........ww
w1w......w..w
w2gw1....+23w
wwwwwwwwwwwww