wwwwwwwwwwwww
w2......1...w
w....3w....ww
w1.3...3w...w
w.....w....1w
w....w..2...w
w...2.......w
wg...A+.....w
wwwwwwwwwwwww