wwwwwwwwwwwww
w2......3...w
ww.....w...ww
w1.32..1....w
w.....13...1w
w...........w
w...2.......w
wg...A+.....w
wwwwwwwwwwwww