wwwwwwwwwwwww
w.....A1....w
ww.3........w
w.......w...w
w...........w
w..........ww
w1w......w..w
w2gw1....+23w
wwwwwwwwwwwww