wwwwwwwwwwwww
w.1...21...2w
w...w.w..w..w
w...3w.w....w
w..3A..+....w
w3w..w.g....w
ww..1.w.....w
w32...1.w123w
wwwwwwwwwwwww