wwwwwwwwwwwww
w2..........w
w...........w
w.2.........w
w...w.2..1..w
w3...w.....3w
w..3w2+g....w
w1...3.Aw...w
wwwwwwwwwwwww