wwwwwwwwwwwww
w21.....w...w
w......w...ww
w1.3...1....w
w......3...1w
w..w........w
w...2.......w
wg...A+.....w
wwwwwwwwwwwww