wwwwwwwwwwwww
w2.........3w
w....2...1..w
w.w.........w
w12......1..w
w..1..2...w3w
w..3.2+g3...w
w1...3.Aw...w
wwwwwwwwwwwww