wwwwwwwwwwwww
w..A..1.wwwww
w33..www3...w
ww....w....+w
ww.1...w....w
w...w..2w1w2w
w1.w........w
w.wg..3w2.31w
wwwwwwwwwwwww