wwwwwwwwwwwww
w2..........w
w........1.ww
w.w........3w
w....w2..1..w
w....w.....3w
w.1...+g3...w
w....23Aw..2w
wwwwwwwwwwwww