wwwwwwwwwwwww
w.....1w....w
w1....w...12w
wwAw.32w....w
w.+.g.3.....w
w......w..3.w
ww.1......www
w12.3.......w
wwwwwwwwwwwww