wwwwwwwwwwwww
w2.........3w
w........1..w
w.w.........w
w.2.........w
w.....2....3w
w..3w.+g3...w
w1...2.Aw...w
wwwwwwwwwwwww