wwwwwwwwwwwww
w..www.1...ww
w..........3w
w..ww.w3....w
w...1g......w
w1.....33.w+w
w..w...1.1w.w
w..Aww..w2..w
wwwwwwwwwwwww