wwwwwwwwwwwww
w2...w1.....w
w.....w3....w
w.w.....w...w
w...w....1..w
w3...w.....3w
w..3w2+g....w
w1...3.Aw...w
wwwwwwwwwwwww