wwwwwwwwwwwww
w1..........w
ww........1.w
wwAw.31w..2.w
w.+.........w
w..........ww
w...g.....www
w12.3.......w
wwwwwwwwwwwww