wwwwwwwwwwwww
w...1A....3.w
w......2....w
w3w..2..1...w
wg..........w
w+w.w......2w
w....w1..21.w
w.3..2......w
wwwwwwwwwwwww