wwwwwwwwwwwww
ww.w........w
w....A......w
w1.3+..1w.3.w
w.w..2..2...w
w..3w...2w1.w
w....wg...13w
w2.1.3.2....w
wwwwwwwwwwwww