wwwwwwwwwwwww
w........3..w
w..3.w...2..w
w..w....+3..w
w........gw.w
wA.........1w
w.....w.....w
ww......1...w
wwwwwwwwwwwww