wwwwwwwwwwwww
ww..........w
w..2.A......w
w1..+..1..3.w
w....2..2...w
w..3w....w1.w
w....wg...13w
w2.1.3.2....w
wwwwwwwwwwwww