wwwwwwwwwwwww
w2.........3w
w........1..w
w.w.........w
w.2.........w
w....w2...13w
w.w.w.+g....w
w1...2.Aw.w.w
wwwwwwwwwwwww