wwwwwwwwwwwww
w3....2+.g..w
w.....w...w.w
w.........2.w
w...2.......w
w....w..1..ww
w..ww2....2.w
w..wA.w.....w
wwwwwwwwwwwww