wwwwwwwwwwwww
w2...w1....3w
w........1..w
w.w.........w
w.2.........w
w.....2....3w
w.....+g3...w
w1...3.Aw...w
wwwwwwwwwwwww