wwwwwwwwwwwww
w...........w
w1....w.....w
w2Aw332ww...w
w.+.g..2....w
w......2.13ww
w.........www
w12.3.......w
wwwwwwwwwwwww