wwwwwwwwwwwww
ww.........3w
w........1..w
w.w.........w
w1..........w
w..1..2....3w
w.....+g3...w
w1..32.Aw...w
wwwwwwwwwwwww