wwwwwwwwwwwww
w21.....3...w
w......w...ww
w1.3...1....w
w......3...1w
w..w........w
w..w2.......w
wg...A+.....w
wwwwwwwwwwwww