wwwwwwwwwwwww
w..2..w.1...w
w+w.2.......w
w.1.g.3w.w.1w
w...w......ww
w.....2.....w
w....Aw.....w
w.....1.....w
wwwwwwwwwwwww