wwwwwwwwwwwww
w........3..w
w..w.w...2..w
w.......+w..w
w.w......gw.w
wA......2..1w
w.....w.....w
w3.21...1...w
wwwwwwwwwwwww