wwwwwwwwwwwww
w....wwww.A.w
ww.....w3g.ww
w....1.w...+w
w3.........ww
w..1...w....w
w......1ww..w
w.w.3.......w
wwwwwwwwwwwww