wwwwwwwwwwwww
w...........w
w1........1.w
w2Aw.3.w....w
w.+.g..2....w
w......2.13ww
w.........www
w12.3.......w
wwwwwwwwwwwww