wwwwwwwwwwwww
w...........w
w1..........w
w.....2ww.w.w
w312wg3...w2w
w.22w..w.1.ww
ww.......ww+w
www.A1..3.3.w
wwwwwwwwwwwww