wwwwwwwwwwwww
w...........w
w1....w.w.22w
wwAw.3www...w
w.+.g.3...w.w
w......w.1..w
ww.1......www
w12.3.......w
wwwwwwwwwwwww