wwwwwwwwwwwww
w2..........w
w...........w
w.w.........w
w1...w2..1..w
w3..1w.....3w
w..3w2+g....w
w1...3.A2...w
wwwwwwwwwwwww