wwwwwwwwwwwww
w...2....3..w
w..3.w...2..w
w..w....+3.1w
w........gw.w
wA.........1w
w.....w.....w
w3......1...w
wwwwwwwwwwwww