wwwwwwwwwwwww
w+..2...1...w
w.....w.....w
w....A....12w
w........ww3w
w3...g...3..w
w3.2..w....2w
w...3..w2...w
wwwwwwwwwwwww