wwwwwwwwwwwww
w2.........3w
w........1..w
w.w.........w
w1..........w
w.....2....3w
w.....+g2...w
w1...3.Aw...w
wwwwwwwwwwwww