wwwwwwwwwwwww
w1.3ww1w..w.w
w...1.2.....w
w...w.2ww.2.w
w31w.g3.....w
w.2....w.1.ww
www......w.+w
www.A.w.3.3.w
wwwwwwwwwwwww