wwwwwwwwwwwww
w2..........w
w...........w
w.w.........w
w1...w2..1..w
w3...w......w
w..3w2+g....w
w1...32Aw...w
wwwwwwwwwwwww