wwwwwwwwwwwww
w..w3...w.A.w
ww2.....3g.1w
w....1.....+w
w31........ww
w......w..w.w
w.3..2.2w...w
w...3.......w
wwwwwwwwwwwww