wwwwwwwwwwwww
w+..2...1...w
w.....w.....w
w....A....11w
w........ww3w
w....g...3..w
w3.2.......2w
w...w...2...w
wwwwwwwwwwwww