wwwwwwwwwwwww
w1.3ww1ww...w
w...1.......w
w...w...w...w
w312.g3...w.w
w.22...w.1.ww
ww.......ww+w
www.A...3.3.w
wwwwwwwwwwwww