wwwwwwwwwwwww
w.1.13.....2w
w......1..2ww
w.2.........w
w.2.w..A.g.ww
ww.....+1.32w
w1....w.....w
w......w3...w
wwwwwwwwwwwww