wwwwwwwwwwwww
w....2ww.wA.w
ww.....w...ww
w....12w...+w
w3.......g.ww
w..1...w....w
w......2w...w
w.w.3.......w
wwwwwwwwwwwww