wwwwwwwwwwwww
w..2..w.1...w
w+w.2.......w
w...g.3w.w.1w
w...w.......w
w.....2.....w
w....Aw.....w
w.1...1.....w
wwwwwwwwwwwww