wwwwwwwwwwwww
w........w..w
w.....1w3w..w
w..1.w.w....w
w2.......g..w
wA31...1...1w
w......2w...w
w3..+.......w
wwwwwwwwwwwww