wwwwwwwwwwwww
w..3..1w....w
w1....w.w..2w
wwA...2ww.w.w
w.+2.g3...w.w
w.........3ww
ww.1......www
w12.3.......w
wwwwwwwwwwwww