wwwwwwwwwwwww
w..A..2...2.w
w33...+.....w
w..2...ww2..w
w.w..g3.....w
w......w.1..w
w.w......3..w
w...1...3...w
wwwwwwwwwwwww