wwwwwwwwwwwww
w3.........ww
w.2....3www+w
w..3.w..w...w
w.w...w..2www
w....w.Aw.w.w
w..2..3.w.g1w
w2.1.3.2....w
wwwwwwwwwwwww