wwwwwwwwwwwww
w1........w.w
ww.3......www
w31..31w...2w
w.1.........w
w........1.2w
w.w.w2.....+w
www.A2wwgw3.w
wwwwwwwwwwwww