wwwwwwwwwwwww
w2.........3w
w........w..w
w.w.........w
w12.........w
w.....2....1w
w.w...+g3...w
w1...3.Aw...w
wwwwwwwwwwwww