wwwwwwwwwwwww
w..A..1w...ww
w33..ww.....w
ww....w.w..+w
ww.1........w
w.....2w.1.2w
w1.w.....ww.w
w.wg2.3w2.31w
wwwwwwwwwwwww