wwwwwwwwwwwww
w2.........3w
w........1..w
w.w.........w
w12.....w1..w
w..1.32....3w
w..2w2+g3...w
w1...w.Aw...w
wwwwwwwwwwwww