wwwwwwwwwwwww
w.1...2....2w
ww..........w
w...3..3....w
w.32A1.+...ww
w3w..3.g....w
w...1.w.....w
w.w.........w
wwwwwwwwwwwww