wwwwwwwwwwwww
w........3..w
w..w.w...2..w
w.......+3..w
w........gw.w
wA.........1w
w.....w.....w
w1.21w..1...w
wwwwwwwwwwwww