wwwwwwwwwwwww
w..A.w.1....w
w......1....w
w..3...w...ww
w.........www
ww.g+..2w...w
w...w....21.w
w.....333.2.w
wwwwwwwwwwwww