wwwwwwwwwwwww
w.....A.....w
ww.3.......3w
ww......w...w
w...........w
w........1..w
w.w........+w
w2gww.....2.w
wwwwwwwwwwwww