wwwwwwwwwwwww
w23..w13wwwww
ww.1..w..13ww
w.w.....w.1.w
w...w.....w.w
w...ww..w.w.w
w.....+g32..w
w....23Aw.22w
wwwwwwwwwwwww