wwwwwwwwwwwww
w2..........w
w.1.........w
w.w.........w
w..3.w2..1..w
w..1.w.....ww
w..3w2+g....w
ww...3.Aw...w
wwwwwwwwwwwww