wwwwwwwwwwwww
w..A........w
w33...+.....w
w...w..ww...w
w.1w.g3.....w
w....2...1..w
w1..........w
w...1...3...w
wwwwwwwwwwwww