wwwwwwwwwwwww
ww.www.1...1w
w..........+w
w1.3g...32.ww
w......w.wwww
ww.....Awwwww
w..2.......2w
w...3...2w..w
wwwwwwwwwwwww