wwwwwwwwwwwww
w1..........w
w.........2.w
w...w.www...w
w312.g3...w.w
w.22...w.1.ww
ww.......ww+w
www.A...3.3.w
wwwwwwwwwwwww