wwwwwwwwwwwww
w.....A.....w
ww.3........w
w.......w...w
w...........w
w.....2....ww
w1w......w.ww
w2gw1....+23w
wwwwwwwwwwwww