wwwwwwwwwwwww
w...w+..1...w
w1......w...w
w....A..2.12w
w.........w3w
w....g......w
w3.2.......2w
w...3...2w.ww
wwwwwwwwwwwww