wwwwwwwwwwwww
w.........2.w
w.......w...w
wA..gw2...1.w
w.....3.w..1w
w.1.w3..www.w
w.w.........w
w...22..+...w
wwwwwwwwwwwww