wwwwwwwwwwwww
w2..........w
w...........w
w.ww.......3w
w1...w2..11.w
w3...w.....3w
w..3w2+g....w
w1...3.Aw...w
wwwwwwwwwwwww