wwwwwwwwwwwww
w.....A.....w
ww.3.......3w
w.......w...w
w.......1.3.w
w......ww..ww
w1w...w..w..w
w2gww.3w2+23w
wwwwwwwwwwwww