wwwwwwwwwwwww
w........3..w
w....w...2..w
w.......+3..w
w........gw.w
wA.........1w
w.....w.....w
w3.2....1...w
wwwwwwwwwwwww