wwwwwwwwwwwww
w..A..2...2.w
w33...+.....w
w..2...ww...w
w.w..g.2....w
w........1..w
w3..........w
w...1.3.3...w
wwwwwwwwwwwww