wwwwwwwwwwwww
w2.........3w
w........1..w
w.w.........w
w........1..w
w..1..2....3w
w..3w.+g3...w
w1...3.Aw...w
wwwwwwwwwwwww