wwwwwwwwwwwww
w.....3....1w
w........22ww
w..3........w
w.......gw..w
w3....1...w.w
w..A.w..+1.1w
w..3........w
wwwwwwwwwwwww