wwwwwwwwwwwww
w....w.2....w
w...........w
w...ww2..3..w
w1....g.13..w
w......3..1ww
w.....132...w
w3..A.+w.1..w
wwwwwwwwwwwww