wwwwwwwwwwwww
w....2w1...ww
w..3..w.2..3w
w..ww.w3....w
w..21g......w
w1.....33.w+w
ww.w...1.1..w
w..Aww..w2..w
wwwwwwwwwwwww