wwwwwwwwwwwww
ww23..g...www
w.......w3.ww
w.+3....w..3w
wA......1w..w
w....22...3.w
w.w.w2w.....w
w.w...1w...1w
wwwwwwwwwwwww