wwwwwwwwwwwww
w..2...w.3..w
w1........1.w
w.Aw.3.w....w
w.+.........w
w.........3ww
w..1g2....www
w12.3.......w
wwwwwwwwwwwww