wwwwwwwwwwwww
w2......3...w
w..w...w...ww
w1.3...1....w
w.....13...1w
w...........w
w...2......1w
wg...A+.....w
wwwwwwwwwwwww