wwwwwwwwwwwww
w...........w
w1........12w
wwAw.3.w....w
w.+.g....w..w
w.........1ww
ww.1......www
w12.3.......w
wwwwwwwwwwwww