wwwwwwwwwwwww
w.1.13.....2w
w.........2ww
w.2..1......w
w.2.w..A.g.ww
ww1w.3.+..32w
w1...3..w...w
w......w3...w
wwwwwwwwwwwww