wwwwwwwwwwwww
w..A......2.w
w33...+...2.w
w.1....ww...w
w.1.wg3.....w
w........1..w
w...........w
w...1..w1...w
wwwwwwwwwwwww