wwwwwwwwwwwww
w..A......2.w
w33...+.....w
w..2...ww...w
w.w..g3.1...w
w........1w.w
w...........w
w...1..w133.w
wwwwwwwwwwwww