wwwwwwwwwwwww
w.....2.1.g.w
w1....w.....w
w..1.w.3..1.w
w...w..2....w
w3+2.ww..w13w
w.22..3.w.A.w
w...ww......w
wwwwwwwwwwwww