wwwwwwwwwwwww
w3....2....2w
w...w.......w
w...3......1w
ww2....A.g..w
ww1w..1+1.3.w
ww3.1.w.....w
w.w.........w
wwwwwwwwwwwww