wwwwwwwwwwwww
w..A......2.w
w33...+.....w
w.......w.1.w
w.1.g..2....w
w........1..w
w...w2......w
w...1...3...w
wwwwwwwwwwwww