wwwwwwwwwwwww
w.........A.w
w..3..1....1w
w.......+..2w
w..g......3.w
w.........www
w1w...w.....w
w32w....ww32w
wwwwwwwwwwwww