wwwwwwwwwwwww
w..A......2.w
w33...+.....w
w......ww...w
w.1w.g..w...w
w.2....w.1..w
ww.......w..w
w...1...3...w
wwwwwwwwwwwww