wwwwwwwwwwwww
w22.........w
w3..........w
w.ww........w
w1...w2..1..w
w3...w.....3w
w..3w2+g....w
w1...3.Aw...w
wwwwwwwwwwwww