wwwwwwwwwwwww
w.1...21...2w
w...w.......w
w...3.......w
w..3A1.+....w
w3...3.g....w
ww..1.w.....w
w.w...1.2..3w
wwwwwwwwwwwww