wwwwwwwwwwwww
w1.3w.1w....w
w...1.w.ww..w
w...w.2ww...w
w312.g3...w2w
w.22...w.1.ww
ww.......ww+w
www.A...3.3.w
wwwwwwwwwwwww