wwwwwwwwwwwww
w.......1..1w
w..w.......+w
w1.w....2.w.w
w.w...3...www
w......A3wwww
ww..2.3w.2g1w
ww.2.21...3.w
wwwwwwwwwwwww