wwwwwwwwwwwww
w2...w1...w1w
w.....w..12.w
w.w..w.....3w
w...w..w..2.w
w3...ww...w.w
w..3w.+g1w.ww
w1...23A..32w
wwwwwwwwwwwww