wwwwwwwwwwwww
w1.3w.1w....w
ww..w.w....ww
w.1.w.2ww..2w
w.1w.g3.....w
w.2....w.1.ww
ww.......ww+w
w.w.A23.3.3.w
wwwwwwwwwwwww