wwwwwwwwwwwww
w2..........w
w...........w
w.w.........w
w1...w2..1..w
w3...w......w
w..3w2+g..3.w
w1...3.Aw...w
wwwwwwwwwwwww