wwwwwwwwwwwww
ww....w1...2w
w...w.......w
w2..3.......w
w2.3A1.+....w
w....3.g....w
ww..1.w.....w
w.w...1.2..3w
wwwwwwwwwwwww