wwwwwwwwwwwww
ww...2ww.wA.w
w......w...ww
w2...1.w...+w
w2.......g.ww
w..1.w.w....w
w......2w...w
w.w.3.......w
wwwwwwwwwwwww