wwwwwwwwwwwww
w..A..2...2.w
w33...+.....w
w...w..ww...w
w.w2.g.2....w
w........1..w
w...........w
w...1.3.3...w
wwwwwwwwwwwww