wwwwwwwwwwwww
ww.3w.....32w
w.........2ww
w2..........w
w2.....A.g..w
w......+1.32w
w3........1.w
www1.3..1.1ww
wwwwwwwwwwwww