wwwwwwwwwwwww
w..31..w...Aw
w...1.1.w..ww
w....w3.w...w
w..3+.32..g.w
w2..1.......w
w.w..2......w
w.......w...w
wwwwwwwwwwwww