wwwwwwwwwwwww
w...w+..1...w
w1....w..w..w
w....A....12w
w......w..www
w....g......w
w3.2.......2w
w..33...2w..w
wwwwwwwwwwwww