wwwwwwwwwwwww
ww23..g...www
w.......w3.ww
w.+3..w.w..3w
wA...w2.1...w
w....w....3.w
w.w.w2w.....w
w.w...1w.2.1w
wwwwwwwwwwwww