wwwwwwwwwwwww
w..A..1w...ww
w33..ww.2...w
ww....ww...+w
ww.1........w
w...w......2w
w1.w........w
w.wg2.3...w1w
wwwwwwwwwwwww