wwwwwwwwwwwww
w..A......2.w
w33...+.....w
w......ww...w
w.1.g.......w
w........1..w
w........w..w
w...1...3...w
wwwwwwwwwwwww