wwwwwwwwwwwww
w...........w
w1........1.w
w.Aw.3.w....w
w.+...3.....w
w.........3ww
w..1g21...www
w12.3.......w
wwwwwwwwwwwww