wwwwwwwwwwwww
ww.3w...w.A.w
w...w...wg..w
w...3w.2...+w
w2.........ww
w......w..w.w
w.3..2.2w...w
w...3.......w
wwwwwwwwwwwww