wwwwwwwwwwwww
w1.3..A.....w
ww.........3w
w.......w...w
w.12....1.3.w
w..........ww
w1w......w..w
w2gww....+23w
wwwwwwwwwwwww