wwwwwwwwwwwww
w+..2...1.w.w
w....1w.....w
w....A....12w
w........3w3w
w....g...3..w
w..2.......2w
w...w...2...w
wwwwwwwwwwwww