wwwwwwwwwwwww
w..1w+..1...w
w1....w.....w
w....A....12w
w..2.....ww3w
w3...g...3..w
w3.2.......2w
w...3...2...w
wwwwwwwwwwwww