wwwwwwwwwwwww
w.....2..w..w
w.A.2.......w
w312......w1w
w.wg.3..33..w
w+.....ww11ww
w.....1...3ww
w.....2.2...w
wwwwwwwwwwwww