wwwwwwwwwwwww
w2..........w
w........1..w
w.w.........w
w12.........w
w..21.2....3w
w..3w2+g33..w
w1...3.Aw...w
wwwwwwwwwwwww