wwwwwwwwwwwww
w.1...2....2w
ww..w.......w
w...3.......w
w.33A1.+....w
w3w..3.g....w
ww..1.w.....w
w.w.........w
wwwwwwwwwwwww