wwwwwwwwwwwww
w...12www.A.w
ww.......w.ww
w......w...+w
w3....w..g.ww
w........3..w
w......222..w
w.w.........w
wwwwwwwwwwwww