wwwwwwwwwwwww
ww.w.13w...1w
w.....w..w.+w
w1.3.A....1ww
w.........www
ww...g.....ww
w..........1w
w..23...2w..w
wwwwwwwwwwwww