wwwwwwwwwwwww
w22.........w
w...........w
w.ww........w
w1.......1..w
w3....2....3w
w..3..+g....w
w1...2.Aw...w
wwwwwwwwwwwww