wwwwwwwwwwwww
w.....A.....w
ww.3........w
w.......w...w
w...........w
w........1.ww
w1w.........w
w2gw1....+23w
wwwwwwwwwwwww