wwwwwwwwwwwww
w2.........3w
w.w......1..w
w.w.........w
w.w2........w
w2w..ww...w.w
www.w.+g1...w
w1.3.w3A..w2w
wwwwwwwwwwwww