wwwwwwwwwwwww
w..A......2.w
w33...+.....w
w.1.....w...w
w.1.g...w...w
w.......21..w
w...........w
ww..1..w1...w
wwwwwwwwwwwww