wwwwwwwwwwwww
w2......3.w.w
w......w.1.ww
w.w.........w
w12.....w12.w
w..w.w2....3w
w..3w2+g3...w
w1...3.Aw..ww
wwwwwwwwwwwww