wwwwwwwwwwwww
w3....2....2w
w...w.......w
w...3.......w
w..3A1.+...2w
w3w..3.g....w
ww..1.......w
w.w.........w
wwwwwwwwwwwww