wwwwwwwwwwwww
w2.........3w
w........1..w
w.w.........w
w12.....21..w
w.w1..2....3w
w..3w2+g3...w
w1...3.Aw...w
wwwwwwwwwwwww