wwwwwwwwwwwww
w2.........3w
w........1..w
w.w3........w
w12.........w
w..w.22....3w
w.w3w2+g3...w
w1...w.Aw...w
wwwwwwwwwwwww