wwwwwwwwwwwww
w.......w.1.w
w...3....w..w
w...w1....1+w
w..1.2..w...w
w..w..3..w..w
w.....A.w2..w
wgw.1...3...w
wwwwwwwwwwwww