wwwwwwwwwwwww
ww.........3w
w........1..w
w.w.........w
ww2..w....w.w
w..1.w2....3w
w..3w2+g3...w
w1.....Aw...w
wwwwwwwwwwwww