wwwwwwwwwwwww
w.....ww.wA.w
ww..w..w...ww
w...3w.w...+w
w3.......g.ww
w..1...w....w
w......2w...w
w.w.w.......w
wwwwwwwwwwwww