wwwwwwwwwwwww
w..A..2...2.w
w33...+.....w
w..w.www....w
w.w.........w
w..w...g.1..w
w.w....323..w
w1..1..w1...w
wwwwwwwwwwwww