wwwwwwwwwwwww
w...wwA.....w
ww.31.......w
w.......w...w
w2..........w
w..........ww
w1w......w..w
w2gw1....+23w
wwwwwwwwwwwww