wwwwwwwwwwwww
ww23..g...www
w........1.ww
w.+3..w....3w
wA...w2.w12.w
w....w......w
w.2.w2w.3...w
w.w...1w...1w
wwwwwwwwwwwww