wwwwwwwwwwwww
w....2ww.wA.w
ww.....w...ww
w....3.w...+w
w3...w...g.ww
w..1...w....w
w......2w...w
w.w.33......w
wwwwwwwwwwwww