wwwwwwwwwwwww
w..A.....12.w
w33...+.....w
w..2...ww...w
w.w..g3.1...w
w........1w.w
w...........w
w...1..21.3.w
wwwwwwwwwwwww