wwwwwwwwwwwww
w2.........3w
w........1..w
w.w......w..w
w....w2..1..w
w....w.1...3w
w..3w.+g3..2w
w1...3.Aw..1w
wwwwwwwwwwwww