wwwwwwwwwwwww
w...........w
w1.....3..1.w
wwAw.31w....w
w.+.........w
w..........ww
w...g.....w1w
w12.3.......w
wwwwwwwwwwwww