wwwwwwwwwwwww
w2.........3w
w........1..w
w.w.........w
w1...2......w
w.2..3.....3w
w.w...+g3...w
w1...3.Aw...w
wwwwwwwwwwwww