wwwwwwwwwwwww
w...12www.A.w
ww.......w.ww
w....w.w...+w
w3....w..g.ww
w..1.....33.w
w......22w..w
w.w.3.......w
wwwwwwwwwwwww