wwwwwwwwwwwww
w2.........3w
w........1..w
w.w.........w
ww2.........w
w....w2....3w
w.w...+g3...w
w1...3.Aw...w
wwwwwwwwwwwww