wwwwwwwwwwwww
ww3.w2ww.wA.w
w......w...ww
w.2..1.w...+w
w3.......g.ww
w..1...31...w
w......2....w
w.w.3...1...w
wwwwwwwwwwwww