wwwwwwwwwwwww
w2...w...w.1w
www...w..1.ww
w.ww.......3w
w.ww....21..w
w2w...2.....w
w.w3..+g1...w
w1..w33A3..2w
wwwwwwwwwwwww