wwwwwwwwwwwww
w3....2..3.2w
w...w.......w
w...3.......w
ww2....A.g..w
ww1w..1+1.3.w
ww..1.w.....w
w.w.........w
wwwwwwwwwwwww