wwwwwwwwwwwww
ww.3w..3..w2w
w.........2.w
w2...33.....w
w2.....A.g..w
w......+1.32w
w.........1.w
www1....1.1ww
wwwwwwwwwwwww