wwwwwwwwwwwww
w.....A.....w
ww.3.......3w
w.......w...w
w.......1.3.w
w..........ww
w11......w..w
w2gww....+2.w
wwwwwwwwwwwww