wwwwwwwwwwwww
w2.........3w
w........1..w
w.w......w..w
w12......1..w
w..1..2....3w
w.22w.+g3...w
w1...3.Aw...w
wwwwwwwwwwwww