wwwwwwwwwwwww
w2......3...w
w..3...w...ww
w1.3..11....w
w......3...1w
w...........w
w...2.......w
wg...A+.....w
wwwwwwwwwwwww