wwwwwwwwwwwww
w2..2w1....1w
w.w...w..1.ww
w.ww.w.....3w
w.w.w..w..2.w
w.w..ww.....w
w.w3w.+g1..ww
w1...23A..32w
wwwwwwwwwwwww