wwwwwwwwwwwww
w....2www.A.w
ww.....w3g.ww
w....1.w...+w
w3.........ww
w......2....w
w.......ww..w
w.w.3.......w
wwwwwwwwwwwww