wwwwwwwwwwwww
w..31..w...Aw
w...1.1.w..ww
w...ww3.w...w
w..3+.32..g.w
w3..1.......w
w.w..2...w..w
w.......w...w
wwwwwwwwwwwww