wwwwwwwwwwwww
w1...w1w..w.w
ww.3w...wwwww
w31.....w..2w
w.1.wg......w
w........1.2w
w.w.w2.....+w
www.A23www3.w
wwwwwwwwwwwww