wwwwwwwwwwwww
w...12www.A.w
ww.....w3g.ww
w....1.w...+w
w3.........ww
w..1...w....w
w.w....2ww..w
w.w.3.......w
wwwwwwwwwwwww