wwwwwwwwwwwww
ww.......3..w
w..w.w.w.2..w
w.......+w..w
w.3......gw.w
wA......2..1w
w...1...w.www
w3.21..w3.www
wwwwwwwwwwwww