wwwwwwwwwwwww
w....2ww.wA.w
ww.....w...ww
w....1.w...+w
w3.......g.ww
w..1...w....w
w.3....2w...w
w.w.3..w....w
wwwwwwwwwwwww