wwwwwwwwwwwww
w.....2.1.g.w
w...........w
w..1...3..1.w
w......2....w
w3+23.w..w13w
w.22..3.w.A.w
w....w......w
wwwwwwwwwwwww