wwwwwwwwwwwww
w1.3ww......w
ww..w.w...www
w.1.w.2ww.22w
w.1w.g3.....w
w.22...w.1.ww
ww.......ww+w
w.w.A.3.3.3.w
wwwwwwwwwwwww