wwwwwwwwwwwww
w3..........w
w.3+1....1..w
w113....A2g.w
w.........1.w
w.....3.....w
w.w.........w
w........223w
wwwwwwwwwwwww