wwwwwwwwwwwww
w2.........1w
w.w........ww
w.w........3w
w.w..w2..1..w
w.w..ww...w.w
w.w3w.+g1..ww
w1...23A..32w
wwwwwwwwwwwww