wwwwwwwwwwwww
w..1w.......w
w....1..1.3.w
w.g....2...3w
w..3.....w.ww
w.A1..1..2.ww
w.+w.w...2..w
w....w..2...w
wwwwwwwwwwwww