wwwwwwwwwwwww
w...........w
w1........1.w
w2Aw.3ww....w
w.+.g..2...ww
w......2.13.w
w.........www
w12.3.......w
wwwwwwwwwwwww