wwwwwwwwwwwww
w1......3...w
w......w...ww
w1.3...3.2..w
w......3...1w
w...........w
w...2.......w
wg...A+.....w
wwwwwwwwwwwww