wwwwwwwwwwwww
w..A......2.w
w33...+.....w
w.....2ww...w
w.1w.g3.....w
w.2....3.1..w
ww..........w
w...1...3...w
wwwwwwwwwwwww