wwwwwwwwwwwww
ww.........3w
w........1..w
w.w.........w
ww2..w.3..w.w
w..1.w2....3w
w..322+g1...w
w1.....Aw...w
wwwwwwwwwwwww