wwwwwwwwwwwww
w.1...21...2w
w...w.......w
w...3w.2....w
w..3A..+....w
w3w..w.g....w
w...2.w.....w
w.w3.w1.w123w
wwwwwwwwwwwww