wwwwwwwwwwwww
w3....2....2w
w...w.......w
w2..3.....1.w
w..3A1.+....w
w3w..3.g....w
ww..1.w.....w
w.w.........w
wwwwwwwwwwwww