wwwwwwwwwwwww
w..A..2...2.w
w33...+.....w
w..2...ww...w
w.3..g.2....w
w.2....w.1..w
ww.......w..w
w...1.3.3...w
wwwwwwwwwwwww