wwwwwwwwwwwww
w+..2...1...w
w.....w.....w
w1.3.A....12w
w........ww3w
ww...g...3..w
w..........2w
w..2w...2...w
wwwwwwwwwwwww