wwwwwwwwwwwww
w3....2+.g..w
w.....w..ww.w
w.........2.w
w...2.......w
w....w..1...w
w..ww2....2.w
w..wA.w.....w
wwwwwwwwwwwww