wwwwwwwwwwwww
w2...w313...w
w.....w....ww
w1.3.......3w
w.....w....1w
w...........w
w...........w
wg...A+.....w
wwwwwwwwwwwww