wwwwwwwwwwwww
w2..........w
w...........w
w.w.........w
w1..ww2..1..w
w3...w.....3w
w..ww2+g....w
w1...3.Aw...w
wwwwwwwwwwwww