wwwwwwwwwwwww
w..2..w.1...w
w+w.2.......w
w...g.3w.w.3w
w.........23w
w.....2..w.3w
w....Aw.....w
w.....1.....w
wwwwwwwwwwwww