wwwwwwwwwwwww
w3..w......2w
w...........w
w22..3..1...w
w.2..w.A.g..w
w31w...+w...w
ww.......3..w
w.w.........w
wwwwwwwwwwwww