wwwwwwwwwwwww
w2...2......w
w....w......w
w.w.........w
w....w2.....w
w....w.....3w
w.....+g3...w
w..1.23Aw..2w
wwwwwwwwwwwww