wwwwwwwwwwwww
w..A......2.w
w3.3..+...2.w
w.1....ww...w
w.w..g3.....w
w........1.2w
w...........w
w...1..w1...w
wwwwwwwwwwwww