wwwwwwwwwwwww
w..A......2.w
w33..w+...2.w
w..2...23...w
w.w..g3.....w
w........1w.w
w...........w
w...1..w1...w
wwwwwwwwwwwww