wwwwwwwwwwwww
w........3..w
w..3.w...2..w
w..w....+31.w
w........gw.w
wA.........1w
ww....w.....w
w3......1...w
wwwwwwwwwwwww