wwwwwwwwwwwww
w..A......2.w
w33...+.....w
w.......w...w
w.1.g..2w...w
w....2...1.3w
w...........w
w...1...3...w
wwwwwwwwwwwww