wwwwwwwwwwwww
w2..2.2w1...w
www..1...+.1w
wA.3ww....w.w
w1.........2w
wg....3.....w
w..3..w....3w
w3...2w.....w
wwwwwwwwwwwww