wwwwwwwwwwwww
w2.........3w
w........1..w
w.w3........w
w12.........w
w.....2....3w
w.w...+g3...w
w1...3.Aw.1.w
wwwwwwwwwwwww