wwwwwwwwwwwww
w.....A.....w
ww.3.......3w
w.......w2..w
w...........w
w..........ww
w1w......w..w
w2gw1....+23w
wwwwwwwwwwwww