wwwwwwwwwwwww
w..A..2...2.w
w33...+.....w
w..2...w....w
w.w..g3.....w
w......2.1..w
w.w....32ww.w
w...1..w1...w
wwwwwwwwwwwww