wwwwwwwwwwwww
w2..........w
w...........w
w.ww........w
w1...w2..11.w
w..........3w
w.w...+g....w
w1...3.Aw...w
wwwwwwwwwwwww