wwwwwwwwwwwww
w....2ww.wA.w
ww.....w.3.ww
w....1.w...+w
w3.......g.ww
w..1...32w..w
w...........w
w.w.3.w.1...w
wwwwwwwwwwwww