wwwwwwwwwwwww
w.1...22...2w
w...w......ww
w...3w.w....w
w..3Aw.+....w
w3w..w.g....w
ww..1.w.....w
w3....1.2123w
wwwwwwwwwwwww