wwwwwwwwwwwww
w2........A.w
w..3.......1w
w.......+..2w
w..g......w.w
w..w......www
w.w....w.w..w
w32w......32w
wwwwwwwwwwwww