wwwwwwwwwwwww
w..A.w......w
w......3....w
w..3........w
w..........ww
ww.g+..2w...w
w...w....21.w
w.....333.2.w
wwwwwwwwwwwww