wwwwwwwwwwwww
w1....A.....w
ww.3.......3w
w.......w...w
w.......1.3.w
w..........ww
w1w......w..w
w2gww....+23w
wwwwwwwwwwwww