wwwwwwwwwwwww
w...........w
w1........1.w
wwAw.31w....w
w.+....w....w
w..........ww
w...g.....www
w12.3.......w
wwwwwwwwwwwww