wwwwwwwwwwwww
w..12+..1...w
w1....w.....w
w....A....12w
w........ww3w
w3...g...3..w
w3.2.......1w
w...3...2...w
wwwwwwwwwwwww