wwwwwwwwwwwww
ww3.w2ww.wA.w
w......w...ww
w.2..1.w...+w
w3.......g.ww
w..1...3....w
w......2w...w
w.w.3.......w
wwwwwwwwwwwww