wwwwwwwwwwwww
w.........A.w
w..3..1....1w
w.......+..2w
w..g2.....3.w
w.........www
w1w....w3...w
w32w....ww32w
wwwwwwwwwwwww