wwwwwwwwwwwww
w...131...3.w
w....A.2....w
w.w.....1...w
wg.....1....w
w+w........2w
w.w....w.21.w
w.3..2......w
wwwwwwwwwwwww