wwwwwwwwwwwww
w2....2.2..2w
w...w.......w
w...3.......w
w..3A1.+....w
w3w..3.g....w
ww..1.w.....w
w.w.........w
wwwwwwwwwwwww