wwwwwwwwwwwww
w..A.1......w
w33...+.....w
w...w..ww...w
w.12.g3.....w
w....2...1..w
w...........w
w...1...3...w
wwwwwwwwwwwww