wwwwwwwwwwwww
w.1...2....2w
ww..w.......w
w.2w.w.....1w
w.w..w...g.ww
ww1.....23A2w
w........w.ww
ww3.+.w.1...w
wwwwwwwwwwwww