wwwwwwwwwwwww
w..A.w.1....w
w......3..w1w
w..3.....2.ww
w......w.wwww
ww.g+..2w...w
w...w....21.w
w.....333.2.w
wwwwwwwwwwwww