wwwwwwwwwwwww
ww.A.w.1....w
w.....21....w
w1.3...w....w
w..........ww
w..g+..2w...w
ww..w....21.w
w.....333.2.w
wwwwwwwwwwwww