wwwwwwwwwwwww
w2...w1...A.w
w..3..w....1w
w.......+..2w
w..g......3.w
w..ww.....www
w.w....w.w..w
w32w......32w
wwwwwwwwwwwww