wwwwwwwwwwwww
w.w......2.3w
w1..11.3....w
w...www.2w.2w
w.3g.A......w
w.........11w
w...2..+..3.w
w.w3.w......w
wwwwwwwwwwwww