wwwwwwwwwwwww
w2........A.w
w..3..w....1w
w.......+..2w
w..gww....3.w
w..w......www
w.w....w....w
w32w......32w
wwwwwwwwwwwww