wwwwwwwwwwwww
w..w2...w.A.w
w.......3g.1w
w.2....w...+w
w32........1w
w......w..w.w
w.3..2.2w...w
w...3.......w
wwwwwwwwwwwww