wwwwwwwwwwwww
w...........w
w1.3......1.w
wwA..31w....w
w.+.........w
w..........ww
w...g.....www
w12.3.......w
wwwwwwwwwwwww