wwwwwwwwwwwww
w2......3...w
w..1...w...ww
w1.....w....w
w..........1w
w...........w
w...2.......w
wg...A+.....w
wwwwwwwwwwwww