wwwwwwwwwwwww
w2..........w
w........1..w
w.w.........w
w12......1..w
w..2..2....3w
w..3w2+g3...w
w1...3.Aw...w
wwwwwwwwwwwww