wwwwwwwwwwwww
w.1.ww21...2w
w...........w
w...3.......w
w..3A1.+....w
w32..3.g....w
ww..1.w.....w
w.w...1.2..3w
wwwwwwwwwwwww