wwwwwwwwwwwww
w3..........w
w..1.A......w
w...+..1..3.w
w.w..2..2...w
w..3w...2w1.w
ww...wg...13w
w2.1.3.2....w
wwwwwwwwwwwww