wwwwwwwwwwwww
w+3....w..w.w
w........w1gw
ww1..w1w....w
w.1.....22..w
w......w....w
w.2.1..2.A.2w
w...3...3.w.w
wwwwwwwwwwwww