wwwwwwwwwwwww
w..A.w.1....w
w......3....w
w..3........w
w..........ww
ww.g+..2w...w
w...w....23.w
w.....33..2.w
wwwwwwwwwwwww