wwwwwwwwwwwww
w2........w1w
w........1..w
w.w........3w
w12......123w
w..w..2....3w
w..3w2+g3...w
w1...w.Aw...w
wwwwwwwwwwwww