wwwwwwwwwwwww
w1.3ww1.....w
w...1.w.....w
w...w.2w.w..w
w312.g32...2w
w.2....w.1.ww
ww.......ww+w
www.A.ww3.3.w
wwwwwwwwwwwww