wwwwwwwwwwwww
w..A2.....2.w
w33...+.....w
w.......w...w
w.1.g..2....w
w......3.1..w
w...........w
w...1...3...w
wwwwwwwwwwwww