wwwwwwwwwwwww
w....w......w
w..........ww
w..3....2..ww
ww.....g.3..w
w.3.......+.w
w.w.2.2.w.32w
w.1.....1w2Aw
wwwwwwwwwwwww