wwwwwwwwwwwwwwwwwwwwwwwwwwwwwwww
w.....d........d........a....a.w
wttttttttttttttttttttttttttttttw
w....................x.........w
w...xx.x.......................w
w..........xx.............xxx..w
w.A.............x..xx..........w
w......xx.................x....w
w...xx...x.....x...x...........w
w...........x.........x....xx..w
w...............x..............w
w....x........x..........x.....w
o..............................i
wwwwwwwwwwwwwwwwwwwwwwwwwwwwwwww