wwwwwwwwwwwwwwwwwwwwwwwwwwwwwwww
w.....a........d........a....d.w
wttttttttttttttttttttttttttttttw
w..............................w
w...x........x.....x...........w
w.......x................x.....w
w.............x..............x.w
w.....x....x.........x.........w
w........x......x.........x....w
w....x............x............w
w............A.........x...x...w
w.......x.........x............w
i..............................o
wwwwwwwwwwwwwwwwwwwwwwwwwwwwwwww