wwwpwwwwwwwwwwwwwwwwwwwww
w.................l.....w
wr......................w
w....vu.................w
w.......................w
w........5.....v........w
w........5...........v..w
w..1.....5..A...........w
w..1..............3.....w
w..1..............3.....w
w.................3.....w
wu......................w
w........r........g.....w
wwwwwwwwwwwwwwwwwwwwwwwww