wwwwwwwwwwwpwwwwwwwwwwwww
w.......g..........r....w
w.....................v.w
w....u.........444......w
w..v....................w
w..........v............w
w..................7....w
w....v......A......7....w
w..................7....w
w.......................w
w..........666........d.w
w.......................w
w.......l...............w
wwwwwwwwwwwwwwwwwwwwwwwww