wwwwwwwwwwwwwwwwwwwwwpwww
w.......................w
w..v....................w
w.l.......999...g.......w
w.......................w
w...5...................w
w...5...................w
w...5.......A...........w
w.......................w
w.......................w
w.......................w
w..v......888..........uw
w...d...................w
wwwwwwwwwwwwwwwwwwwwwwwww