wwwwwwwwwwwwwwwww
wg0..bb...bb.bb.w
w0..b...........w
w..b...b..b...b.w
wb....b.Ab.b...bw
w.b...b..b..b..bw
wb.b....b.b.b...w
w.b.b..b.b.b..c.w
wbbb..b.b..b..b.w
wwwwwwwwwwwwwwwww