wwwwwwwwwwwwwwwwwwwwwww
w.....................w
w.....................w
w....c..c..A..c..c....w
w.....w.w..w..w.w.....w
w.....................w
w....cw.w.0w0.w.wc....w
w........00000........w
w....cw.w00g00w.wc....w
w........00000........w
w....cw.w.0w0.w.wc....w
w.....................w
w.....w.w..w..w.w.....w
w....c..c..c..c..c....w
w.....................w
w.....................w
wwwwwwwwwwwwwwwwwwwwwww