wwwwwwwwwwwwwwwwwwww
w.....w...w.c.w.qs.w
wqw..wq...qw..gwqwqw
w.....w...w...w....w
w...s.q..Aq....c...w
w.s...wqqqw...w....w
wqw..wq...qw..qwq..w
w..c..wc..w...w...sw
wwwwwwwwwwwwwwwwwwww
