wwwwwwwwwwwwwwwwwwwwwwwwwwww
w..w0w........0........w0w.w
w..........................w
w...1...w...1.....www.....1w
w.....1.w....1.1...1.......w
w0.......w................0w
w.........1...wwww...1.....w
w....1........w.1......1...w
w.........A................w
w..w0w........0........w0w.w
wwwwwwwwwwwwwwwwwwwwwwwwwwww