wwwwwwwwwwwwwwwwwwwwwwwwwwww
w00w.......................w
w00w.................1.....w
w00w......1................w
w.ww..........1....1...1...w
w......0..............1....w
w...........1..........1...w
w............0....1.1......w
w......................wwwww
w.....A..................00w
wwwwwwwwwwwwwwwwwwwwwwwwwwww