wwwwwwwwwwwwwwwwwwwwwwwwwwww
w..1.....1..w...0.0.0.0w000w
w.1....................w000w
w...1...0.....A........w000w
wwwwwwwwwwww.............00w
w0..................w.....ww
w0......1..................w
w0.........wwwww....1.....0w
wwwww................w.....w
w........0.0.0.0.0...w0...0w
wwwwwwwwwwwwwwwwwwwwwwwwwwww