wwwwwwwwwwwwwwwww
w......0........w
w.g......c......w
w....b....c.....w
w.............0.w
w.A.m.c..c..c..gw
w...........b...w
w....0..........w
w.........g.....w
wwwwwwwwwwwwwwwww