wwwwwwwwwwwwwwwww
w...............w
w.m.............w
w...m..c.c..b...w
w...............w
w......A........w
w...............w
w...c.....g.....w
w.b........0....w
wwwwwwwwwwwwwwwww