wwwwwwwwwwwwwwwww
w...............w
w......g...c....w
w...............w
w...A......m....w
w...............w
w........b......w
w......0........w
w...............w
wwwwwwwwwwwwwwwww