wwwwwwwwwwwww
w...........w
w......1....w
w..h..b..h..w
w....1......w
w..3....2...w
w...a.h..c..w
w....3....2.w
w.....A.....w
wwwwwwwwwwwww