wwwwwwwwwwwww
w..a..b..c..w
w...........w
w...........w
whhhhh.hhhhhw
w....h.h....w
w.12.h.h.13.w
w.3.......2.w
w.....A.....w
wwwwwwwwwwwww