wwwwwwwwwwwwwwwwww
w........w.x.....w
w.bh.....w.h.....w
wwwwwww..........w
w...b.w22wwwwww33w
w.....w......1...w
w11111...1.....1.w
w..1......wwwwwwww
w...........1..c.w
w...A...w...1....w
wwwwwwwwwwwwwwwwww