wwwwwwwwwwwwww
w..lA........w
w..wwwwww.woww
w..t.........w
w..wwwwwwww..w
w..w....k.w..w
w..w..p...w..w
w..w...wwww..w
w..w...b.....w
w..w.....w...w
wwwwwwwwwwwwww