wwwwwwwwwwwwww
w............w
w............w
w..p......o..w
w............w
w......A.....w
w............w
w............w
w..b......t..w
w............w
wwwwwwwwwwwwww