wwwwwwwwwwwwww
w.....w......w
w..b..w...o..w
w............w
wwww....w....w
w......Aw....w
wwwww...wwwwww
w..pw.......kw
w...l.....t..w
w...w....w...w
wwwwwwwwwwwwww