wwwwwwwwwwwwwww
w...1w.....g..w
w....d........w
w....ww.www.wdw
wA...w......w.w
w....w...g..w.w
w0...w......w.w
wwwwwwwwwwwww.w
wr..w...w.....w
w...w...w.y...w
w...w...w.....w
w...d.b.w...y.w
w..rw...w.....w
w...wwwwwwdwwww
w.............w
wwwwwwwwwwwwwww
