wwwwwwwwwwwwwww
www..A.....0www
www........1www
wwwwwwwdwwwwwww
w....g........w
w.............w
w..........g..w
wwwwwwwwwwwdwww
w.....w.......w
w..r..w..y....w
w.....w.......w
w.r...w..y....w
w.....d.......w
wwdwwwwwwwwwwww
w............bw
wwwwwwwwwwwwwww
