wwwwwwwwwwwwwww
wwwwww.....y..w
wwwwww..y.....w
wwwwwwwdwwwwwdw
wb..w....r..w.w
w...d.......w.w
w...w......rw.w
wwwwwwwwwwwww.w
w1.0w.......w.w
w...w...g...w.w
w...w.......w.w
w...d.g.....w.w
w...w.........w
w.A.wwwwwwwwwww
w.............w
wwwwwwwwwwwwwww
