wwwwwwwwwwwwwwwwwwwwwwwwwwwwwww
w.............................w
w...w.....t...w......wwwww....w
w.A.w.........w...............w
w...w.........w...t...........w
w..ww.........................w
w........wwwwww...........t...w
w...t.........t..w............w
w................w............w
w.....wwwwww.....w.....wwwww..w
w...................t....w....w
w.......t......wwww......w....w
w...wwww.................w...gw
w................t............w
wwwwwwwwwwwwwwwwwwwwwwwwwwwwwww
