wwwwwwwwwwwww
w...........w
w.wwwwwwwww.w
w.w..2......w
w.w.........w
w.w.wwwwwwwww
w.w..2......w
w.w.........w
w.w....2...lw
w.wwwwwwwwwww
wA........+gw
wwwwwwwwwwwww
