ww3www3wwwwwwwwwwwwwwwwwwwwwwww
..............................1
...............................
.A............................1
...............................
..............................1
...............................
...............................
...............................
.......0.00...000000.....000...
.......0.00..00000000...0000...
.......00000000....000..000....
......000000000000000000000....
wwwwwwwwwwwwwwwwwwwwwwwwwwwwwww