wwwwwwwwwwwwwww
w....b........w
w.+..w2....-..w
w....wwwwww...w
w....w....w...w
w.1..w..e.w...w
w....w....w...w
wwwawwwwdwwwcww
w.....w.......w
w.*..0w../....w
w.....w.......w
w..A..w....3..w
wwwwwwwwwwwwwww