wwwwwwwwwwwwwww
w.............w
w..2........-.w
w.............w
wwwwbwwwwwwwaww
w........w0...w
w./......w.*.Aw
w.......3w....w
wwwwcwwwwwwwaww
w..w...w......w
we.d...w.+...1w
w..w...w......w
wwwwwwwwwwwwwww