wwwwwwwwwww
wcc....cccw
wcc.c..cccw
wce.c.....w
www.w.w.c.w
wg11111..Aw
www.w.w...w
wce.cc..c.w
wcc..c....w
wccc...cccw
wwwwwwwwwww
