wwwwwwwwwwwww
w.1..1.1...xw
w...h..1.1..w
w11111111111w
wh.1..1..1..w
wwwwww.1..1.w
w...1...1.1.w
wA.1..h.1..1w
wwwwwwwwwwwww
