wwwwwwwwwwwww
wx..111...1.w
w..1.1ww111.w
w..11.11h1..w
whhh.1.1..11w
www.11.11.11w
w.1.1.11.h1.w
w.1.1.A.1.1.w
wwwwwwwwwwwww
