wwwwpwwwwwwwwwwwwwwwwwwww
w......d................w
w...........d.........r.w
w.......................w
w..d.........b..........w
w.......................w
w...........A...........w
w................s......w
w.......................w
w.......................w
wu......h...............w
w...................d...w
w.......................w
wwwwwwwwwwwwwwwwwwwwwwwww
