wwwwwwwwwwwwwwwwwwwwwpwww
w.......................w
w.r..........b..........w
w.......................w
w......................uw
w.......................w
w...........A...........w
w....wwwwwwwwwwwwwwwwwwww
w......................hw
w.......................w
w......................tw
w.......................w
w......................sw
wwwwwwwwwwwwwwwwwwwwwwwww
