wwwwwwwwwwwwwwwwwwwpwwwww
w.....l.................w
w.......................w
w......................dw
w..A....................w
w........b............r.w
w................b......w
w.......................w
w..b....................w
w.......................w
w.......................w
ws.....................hw
w.......................w
wwwwwwwwwwwwwwwwwwwwwwwww
