wwwwwwwwwwwwwwww
w---0........--w
w............--w
w............3-w
w2,,,,,,,,,..--w
r...........w.1w
r...........w..w
wA--0...-w.....w
wwwww...-w.....w
wg......-wwww..w
w-w-....3w--0..w
w-w0.....w.....w
w-w............l
w-www....---...w
w-.......32----w
wwwwwwwwwwwwwwww
