wwwwwwwwwwwwwwww
w....--A-------w
w..............l
w..............l
w....,,,,,.....w
w-...-3-0-....-w
w-...--1--....-w
r.............-w
w..............w
w-...0---3....1w
w-...wwwww.....w
w-.....-w......w
w0.....-w......w
ww.....3w......w
wg............3w
wwwwwwwwwwwwwwww
