wwwwwwwwwwwwwwww
wg.............w
w-....3w......3w
w-....,......3-w
wwwwwww2.....--w
w,,,,,,-0....--w
r.....wwww.....w
w.....l........w
r.....w........w
w-w....320....-w
w-w-...---..3w-w
w-w-...-.-..-w-w
w-w-...-.-..-w-w
w-.-...-.-..-.-w
w---...-A-..---w
wwwwwwwwwwwwwwww
