owqrqqrqwo
o..z..x..o
oqw.ww.wqo
oe.e..e.eo
o........o
o........o
o........o
o........o
o........o
o........o
o........o
o........o
o........o
o........o
o........o
o........o
o........o
o........o
o...A....o