oerererero
o..z..x..o
o........o
o........o
o........o
o........o
o........o
o........o
o........o
o........o
o........o
o........o
o........o
o........o
o........o
o........o
o........o
o........o
o...A....o