wwwwwwwwwwwwwwwwwwwwwwwwwww
w..........t++xt.i.......iw
w....s.....t+lxti....i....w
w...........+++..........iw
wt...ttt.t.t+++ttt..tt...tw
w=__========x_=======_====w
w========_=============_==w
w===-==========--=========w
wtt...tt..tt+++tt..t..tt.tw
wi.....i....+l+.......i...w
w.....i....t+++t..i......iw
w..i......it+++ti.....i...w
wwwwwwwwwwwwwwwwwwwwwwwwwww
