wwwwwwwwwwwwwwwwwwwwwwwwwww
w.i.....i..t++xt.i.......iw
w...i.......+x+......i....w
wi...i.....t+++ti........iw
wt...ttt.t.t+++ttt..tt...tw
w=_====_=====_=========_==w
w========_========_=======w
w===-==========-======-===w
wtt...tt..tt+++tt..t..tt.tw
w...........+++.......i...w
w.....s....tx+lt..i......iw
w..........t+++ti.....i...w
wwwwwwwwwwwwwwwwwwwwwwwwwww
