................
.t...........g..
.x...........x..
.....xxxxx......
.....p.p.p......
................
.....bbbbb......
.......x........
......xAx.......
.......x........
