....p.....xgx...
................
..xxxx....p.....
................
........xxx.....
...b............
...xxxx....p....
............xAx.
..xt...pp....x..
................
