wwwwwwwwwwwwwwwwwwwwwwwwwwww
w...................e.e....w
w...........o..............w
w................d.........w
w.b.......e.u..............w
w...w.............o.b......w
w...ew.....................w
w.A.................wowwwwww
w.................t.w.....gw
wwwwwwwwwwwwwwwwwwwwwwwwwwww
