wwwwwwwwwwwwwwwwwwwwww
w.......,,,,,,,......w
w.....h.,,,,,,,....d.w
w...h...,,,,,,,...d..w
w.h.....,,,,,,,..d...w
w.......,,,,,,,......w
w.......,,,,,,,......w
w.......,wwwww,......w
w,,,,,,,,w726w,,,,,,,w
ww.w.w.w,wwwww,......w
ww.w.w.w,,,w,,,......w
w.......,,,w,,,......w
wwww.www,,,w,,,......w
w.......,,,w,,,..r...w
w.......,,,w,,,...g..w
w...A...,,,w,,,....b.w
wwwwwwwwwwwwwwwwwwwwww
