wwwwwwwwwwwwwwwwwwwwww
w.......,,,,,,,......w
w.....h.,,,,,,,..d...w
w...h...,,,,,,,...d..w
w.h.....,,,,,,,....d.w
w.......,,,,,,,......w
w.......,,,,,,,......w
w.......,wwwww,......w
w,,,,,,,,w429w,,,,,,,w
ww.w.w.wwwwwww,......w
ww.w.w.ww,,,,,,......w
w.......w,,,,,,......w
wwww.wwww,,,,,,......w
w.....wb,,,,,,,..l...w
w.....wg,,,,,,,...l..w
w...A.wr,,,,,,,....l.w
wwwwwwwwwwwwwwwwwwwwww