w....m.....f....m...f..w
w......................w
w......................w
w......................w
w......................w
w......................w
w...........A..........w
w......................w
w......................w
w......................w
w...c..............c...w
wwwwwwwwwwwwwwwwwwwwwwww