wwwwwwwwwwwwwwwwwww
w+2i++++++++++++++w
w+ir+x++++++++++++w
w++++v++++++v+++++w
w++++++v+A++++++++w
w+h+++++++++++++++w
w++++++++h++++++++w
w+++++wwww++++++++w
w+++++wg3w+++++++ow
wwwwwwwwwwwwwwwwwww
