wwwwwwwwwwwwwwww
w..++++++++++..w
w.........+++..w
w..ooAoo..+++..w
w..+++++..+....w
w..+o+o+..+tk..w
w..............w
w..............w
w++++++++++++++w
woooooooooooooow
woooooooooooooow
wgl++++++++++++w
wwwwwwwwwwwwwwww
