tcsc.fcsct
+sc.ss.cs+
x........x
+........+
x........x
+........+
x........x
+........+
x........x
+........+
x........x
+........+
x........x
+........+
x....A...x