ts.cf.c.st
+c.ssss.c+
x........x
+........+
x........x
+........+
x........x
+........+
x........x
+........+
x........x
+........+
x........x
+........+
x....A...x