wwwwwwwwwwwwwwwwwwwwwwwwwwwwwwww
w3ssssslsssssssssssslsssssssss2w
ws.0.......000.....00...00000.sw
ws00.......000..............00uw
ws..........................00sw
wd00..........................sw
ws00...........A..............sw
ws00..........................sw
ws..........................00sw
ws00........................00uw
ws00.........00000..........00sw
ws.0......00.00000.00....0000.sw
w4sssssrsssssssrsssssssrssssss1w
wwwwwwwwwwwwwwwwwwwwwwwwwwwwwwww
