wwwwwwwwwwwwwwwwwwwwwwwwwwwwwwww
w3ssssslsssssssssslslsssssssss2w
ws.......0000000........00000.sw
ws00.....0000000............00sw
ws00........................00sw
wd00..........................uw
wd00...........A..............sw
ws............................sw
ws..........................00sw
ws00........................00uw
ws00......00.00.00.00....00000sw
ws.0......00.00.00.00....0000.sw
w4sssssssrsssssssssrssssssssss1w
wwwwwwwwwwwwwwwwwwwwwwwwwwwwwwww
