w2.......w
w+++pp+++w
w++pppp++w
w+p+pp+p+w
w+p+pp+p+w
wppppApppw
w+p+pp+p+w
w+p+pp+p+w
w++pppp++w
w+++pp+++w
w.......1w