w2.......w
w++++++++w
w++bbbb++w
w+bbbbbb+w
w+bb++bb+w
w+bb+Abb+w
w+bb++bb+w
w+bbbbbb+w
w++bbbb++w
w++++++++w
w.......1w