w2.......w
w+++bb+++w
w++bbbb++w
w+bbbbbb+w
w+++bb+++w
w+++bA+++w
w+++bb+++w
w+bbbbbb+w
w++bbbb++w
w+++bb+++w
w.......1w