wwwwwwwwwwwwwwww
w..............w
w..........1...w
w..............w
w..............w
wwwww....www...w
w..............w
w..............w
w..............w
w..A...........w
w..........ww..w
w........ww....w
w........w.....w
w............1.w
wwwwwwwwwwwwwwww
