wwwwwwwwwwwwwwwwwww
w+.+...+w+++...+++w
w+++-++w+w++12+..+w
w+.++-+w+++.++++++w
w++0+++w++w+++..++w
w+++w+++w+++-+-+++w
w+.+.+2++w++w+.+++w
w++-++2++-+w++++++w
w+++01++w+1++2++++w
w+++-------++....Aw
wwwwwwwwwwwwwwwwwww