wwwwwwwwwwwwwwwwwww
wA++.++++++++..++1w
w.+.+++++++++..++0w
wwwww++++++++wwwwww
w+++++w+..+++++w1.w
w+0+-+wwwwwww++++ww
w++.++++++++++++++w
wwwww+++++www+++++w
w++1w+++++++++++++w
w++++++++...+0++www
wwwwwwwwwwwwwwwwwww