wwwwwwwwwwwww
w...........w
w...+.......w
w.+.+.+...--w
w.+.++++g.--w
wA@g++..----w
w.+.++...---w
w.+.+....-r-w
w.+......---w
w.+++++++---w
wwwwwwwwwwwww
