wwwwwwwwwwwwww
w.lA.........w
w.wwwwwww.whww
w............w
w.wwwwwwww...w
w.w....k.w...w
w.w..c...w...w
w.w...wwww...w
w.w...b......w
wsw......w...w
wwwwwwwwwwwwww
