wwwwwwwwwwwwwwwwwwwwwwww
w...w..........0......tw
w.0.w.0.www.....wwwwwwww
w...w..................w
w..A...................w
w.........ww....ffff+ffw
w..w..0....w....+e..e..w
w.....ww......d.f......w
wwwwwwwwwwwwwwwwwwwwwwww