wwwwwwwwwwwwww
w.....w......w
w..b..w...c..w
w............w
wwww....w....w
w......Aw....w
wwwww...wwwwww
w..sw.......kw
w...l.....h..w
w...ww...w...w
wwwwwwwwwwwwww
