wwwwwwwwwwwwwwww
w...3..........w
w..x3.....x....w
w.w.3..........w
w.w.3.344444444w
w.w.3.3........w
w.w.223.......xw
w...ww2A44444..w
w...www1...wwwww
w...w..1......ew
w2222221.......w
w......14444444w
w.xw.221.......w
w..w.1.....x...w
w....1.........w
wwwwwwwwwwwwwwww
