wwwwwwwwwwwwwwww
w.e..w.........w
wwwwnw....3444.w
w..w1.....3..1.w
w..w1444444..1.w
w.xwwwwwwww..1.w
w...3........1.w
ww.w3w2223...1.w
w22223www22221.w
w..x.2223wwwwwww
w.......2222234w
wwwwwww.w....31w
w22222223....31w
w...x...22222A1w
w..............w
wwwwwwwwwwwwwwww
