wwwwwwwwwwwwwwwwwwwwwwwwwwwwwwww
........................s......2
..............s.....s.........12
..............................12
................s.............12
...A.....................s....12
.............s................12
.............s................12
...................s..........12
..........................s....2
wwwwwwwwwwwwwwwwwwwwwwwwwwwwwwww