.......s............s.........12
.......s...........s.s........12
........s.........s...s.......12
.........s.......s.....s......12
...A......s.....s......s......12
...........s...s.......s......12
............s.s........s.......12
.............s.........s......12
.............s.........s......12