.........s..........s..........2
......s.......................12
..............s...............12
....................s.........12
...A........s.................12
................s.............12
.........s..............s.....12
..............................12
....s..............s...........2