wwwwwwwwwwwwwwwwwwwwwwwwwwwwwwwwwwwwww
w4___l_____l______________l_____l___2w
w___0______a0_____0_____0_____0____0_w
w___p___________g__________________3_w
w___A________________________________w
wwwwwwwwwwwwwwwwwwwwwwwwwwwwwwwww____w
w____________________________________w
w___3______________________________2_w
w________0____0_______0______0___0___w
w4_____,_________,______,___________2w
www___wwwwwwwwwwwwwwwwwwwwwwwwwwwwwwww
w____________________________________w
w___4_________________h____________e_w
w____0___0____________0b_____0___0___w
w4_____,_____,_______________,___,__2w
wwwwwwwwwwwwwwwwwwwwwwwwwwwwwwwwwwwwww
