wwwwwwwwwwwwwwwwwwwwwwwwwwwwwwwwwwwwww
w4___l_l___l__l______l____l_____l___2w
w___0_______0_____0_____0_____0a___0_w
w___3____g_________________________x_w
w__________________________________A_w
www___wwwwwwwwwwwwwwwwwwwwwwwwwwwwwwww
w____________________________________w
w___4_________________h____________e_w
w____0___0____________0b_____0___0___w
w4_____,_____,___,___,__,_,__,___,__2w
wwwwwwwwwwwwwwwwwwwwwwwwwwwwwwwwwwwwww
