x+x+x+x+x+x+x+x+x+x+x+x+x+x+x+t
b.............................p
b.............................p
b.............................p
b.............................p
b.............................p
b......A......................p
b.............................p
x+x+x+x+x+x+x+x+x+x+x+x+x+x+x+t